napkin	'næpkɪn	салфетка
exit	'eksɪt,'egzɪt	выход
gadget	'gæʤɪt	приспособление
we	wi:	мы
couple	'kʌpl	пара,  двое,  соединять
persecute	'pɜ:sɪkju:t	преследовать,  подвергать гонениям (убеждения)
academic	,ækə'demɪk	академический,  учебный,  теоретический
branch	brɑ:nʧ	ветвь,  отрасль
hill	hɪl	холм,  куча,  насыпать кучу
guide	gaɪd	проводник, гид,  экскурсовод
sufficient	sə'fɪʃ(ə)nt	достаточный,  обоснованный
roast	rəʊst	жарить,  печь
never	'nevə	никогда
politician	,pɒlɪ'tɪʃ(ə)n	политик,  государственный деятель
vast	vɑ:st	обширный, громадный
gilt	gɪlt	позолота
mirror	'mɪrə	зеркало
silver	'sɪlvə	серебро
steep	sti:p	крутой,  чрезмерный,  погружать (в жидкость)
react	rɪ'ækt	реагировать (на что-л.)
lap	læp	подол,  колени,  жидкая пища (для собак)
bled	bled	прош.вр. bleed - истекать кровью
awful	ɔ:f(ə)l	страшный,  отвратительный
dawn	dɔ:n	рассвет,  начало
hungry	'hʌŋgrɪ	голодный
stable	'steɪbl	устойчивый,  конюшня
decide	dɪ'saɪd	решать,  делать выбор
counsel	'kaʊn(t)s(ə)l	обсуждение,  план действий,  совет
melt	melt	таять,  плавиться
sparkle	'spɑ:kl	искорка,  блеск,  сверкание
parting	'pɑ:tɪŋ	расщепление,  прощание
wolf	wʊlf	волк
domestic	də'mestɪk	домашний,  семейный
drawback	'drɔ:bæk	препятствие
undo	ʌn'du:	открывать,  расстёгивать
concrete	'kɒŋkri:t	бетон,  затвердевать,  определённый,  точный
nice	naɪs	хороший,  приятный
ambassador	æm'bæsədə	посол,  представитель
throughout	θrʊ'aʊt	через,  по всей площади,  длине
into	'ɪntə, 'ɪntu:	в, на, внутрь
playwright	'pleɪraɪt	драматург
hothouse	'hɒthaʊs	оранжерея,  теплица
shy	ʃaɪ	робкий,  бросать,  кидать
plaster	'plɑ:stə	штукатурка,  пластырь,  замазывать
justice	'ʤʌstɪs	справедливость,  судья
presume	prɪ'zju:m	предполагать,  осмелиться,  притворяться
ripe	raɪp	зрелый,  спелый
bore	bɔ:	отверстие,  сверлить,  скучное занятие
command	kə'mɑ:nd	команда,  приказ
overcoat	'əʊvəkəʊt	пальто,  шинель
barber	bɑ:bə	парикмахер,  сильный ветер при морозе
active	æktɪv	активный,  деятельный,  инициативный
tower	'taʊə	башня
who	hu:	кто?
instance	'ɪn(t)stən(t)s	пример,  случай
misfortune	mɪs'fɔ:ʧu:n	беда,  неудача
ambition	æm'bɪʃ(ə)n	честолюбие,  цель,  предмет желаний
valid	'vælɪd	действительный,  имеющий силу
flee	fli:	убегать
incident	'ɪn(t)sɪd(ə)nt	случай,  происшествие
barley	bɑ:lɪ	ячмень (Hordeum vulgare)
slave	sleɪv	раб
collision	kə'lɪʒ(ə)n	столкновение
agent	eɪʤ(ə)nt	агент,  представитель,  действующая сила
probable	'prɒbəbl	вероятный,  возможный
pregnant	'pregnənt	беременная,  чреватый (чем-л.)
typical	'tɪpɪk(ə)l	типичный
engrave	ɪn'greɪv	гравировать,  вырезать (по камню, дереву)
catch	kæʧ	ловить,  поймать
bass	bæs	окунь,  американская липа
party	'pɑ:tɪ	сторона в сражении,  политическая партия,  вечеринка
refuse	rɪ'fju:z	отвергать,  отказывать,  мусор
path	pɑ:θ	тропинка,  дорожка
power	'paʊə	сила,  энергия
symbol	'sɪmb(ə)l	символ,  эмблема
congratulate	kən'græʧʊleɪt	поздравлять (с чем-л.)
sentence	'sentən(t)s	фраза,  высказывание
gait	geɪt	походка
estimate	'estɪmeɪt	оценивать, производить оценку, устанавливать цену, стоимость
pal	pæl	друг,  приятель
trip	trɪp	путешествие,  спотыкаться
recover	rɪ'kʌvə	возвращать,  получать обратно
find	faɪnd	находить
put	pʊt	класть,  ставить
creep	kri:p	ползать,  пресмыкаться
chimney	ʧɪmnɪ	труба (дымовая ),  кратер вулкана
nuisance	'nju:s(ə)n(t)s	досада,  неприятность
joint	ʤɒɪnt	сочленение,  сустав
trouble	'trʌbl	беспокойство,  тревога
meet	mi:t	встречать,  знакомиться
leap	li:p	прыжок
error	'erə	ошибка
excursion	ɪks'kɜ:ʃ(ə)n	путешествие,  экскурсия
foreground	'fɔ:graʊnd	самое важное место,  центральная позиция
rubber	'rʌbə	резина,  каучук
too	tu:	также,  слишком
fender	'fendə	каминная решётка,  ограда
since	sɪn(t)s	с тех пор,  впоследствии,  позднее
solid	'sɒlɪd	твёрдый (а не жидкий),  цельный,  прочный
petty	'petɪ	мелкий,  второстепенный
appointment	ə'pɒɪntmənt	назначение (на должность),  условленная встреча
torch	tɔ:ʧ	факел,  фонарь
prepare	prɪ'peə	готовить,  подготавливать (к чему-л.)
reply	rɪ'plaɪ	ответ
eat	i:t	есть,  поедать
lame	leɪm	хромой,  неправильный,  тонкий лист
soccer	'sɒkə	футбол
treaty	'tri:tɪ	договор,  переговоры
mix	mɪks	перемешивание,  смесь
imagine	ɪ'mæʤɪn	воображать,  представлять себе
tributary	'trɪbjət(ə)rɪ	данник,  тот кто платит дань
perspire	pə'spaɪə	потеть
congress	'kɒŋgres	конгресс,  съезд
union	'ju:njən	объединение,  союз
mission	'mɪʃ(ə)n	миссия,  поручение,  командировка
liable	'laɪəbl	обязанный,  ответственный
moderate	'mɒd(ə)rət	умеренный,  избегающий крайностей
destiny	'destɪnɪ	судьба
well	wel	хорошо,  колодец,  подниматься (о воде)
bracelet	breɪslɪt	браслет,  наручники
gaze	geɪz	пристально глядеть
heir	eə	наследник
sugar	'ʃʊgə	сахар
sell	sel	продавать
aspen	æspən	осина (дерево) (Populus tremula),  дрожащий
latter	'lætə	недавний,  последний
section	'sekʃ(ə)n	секция,  деталь (сооружения, конструкции)
lettuce	'letɪs	салат-латук
hot	hɒt	горячий
blind	blaɪnd	слепой,  блёкло отпечатанный,  неясный
fan	fæn	веер,  вентилятор,  фанат
genre	ʒɒŋrə	жанр,  манера,  литературный стиль
pacific	pə'sɪfɪk	мирный,  спокойный
place	pleɪs	место,  сиденье
restore	rɪ'stɔ:	отдавать обратно,  возвращать на прежнее место
machine	mə'ʃi:n	машина,  механизм
orchard	'ɔ:ʧəd	фруктовый сад
solve	sɒlv	растворять,  разрешать (проблему и т. п.)
humble	'hʌmbl	простой,  скромный,  безрогий
pleasant	'plez(ə)nt	приятный
fire	'faɪə	огонь,  пламя
insure	ɪn'ʃʊə	страховать,  застраховывать
factory	'fækt(ə)rɪ	завод
clothe	kləʊð	одевать (кого-л.)
enemy	'enɪmɪ	враг
bare	beə	голый
push	pʊʃ	толкать,  надавливать
flower	'flaʊə	цветок
tire	'taɪə	передник,  фартук,  утомляться
grip	grɪp	схватить,  сжать
advantage	əd'vɑ:ntɪʤ	преимущество,  выгода,  польза
entire	ɪn'taɪə	полный,  целый
patch	pæʧ	лоскут,  заплата,  шут гороховый
compliance	kəm'plaɪən(t)s	согласие,  соответствие,  уступчивость
die	daɪ	умирать,  игральная кость
lottery	'lɒt(ə)rɪ	лотерея
accepted	ək'septɪd	общепринятый,  обычный,  распространенный
gallop	'gæləp	галоп,  спешка
nest	nest	гнездо
throat	θrəʊt	горло
hole	həʊl	отверстие,  прорезь,  яма
ache	eɪk	боль (обычно продолжительная, тупая)
rather	'rɑ:ðə	лучше,  предпочтительнее
ashore	ə'ʃɔ:	к берегу,  на берег
mail	meɪl	почта,  чешуя,  кольчуга
earnest	'ɜ:nɪst	серьёзный,  авансовый платёж
indoor	,ɪn'dɔ:	находящийся в помещении,  комнатный
vital	'vaɪt(ə)l	жизненный,  энергичный
accusation	,ækjʊ'zeɪʃ(ə)n	обвинение
invite	ɪn'vaɪt	приглашать,  звать
gallant	'gælənt	любезный,  внимательный
perhaps	pə'hæps, præps	может быть,  наверно
blanket	blæŋkɪt	шерстяное одеяло,  попона
press	pres	надавливание,  срочность,  вербовать насильно
nostril	'nɒstr(ə)l	ноздря
keen	ki:n	острый
imitate	'ɪmɪteɪt	подражать,  копировать (что-л.)
vigorous	'vɪg(ə)rəs	сильный,  энергичный
dial	'daɪəl	циферблат,  наборный диск (телефона)
return	rɪ'tɜ:n	возвращаться,  отдавать
ceiling	si:lɪŋ	потолок,  навес
taste	teɪst	вкус
oral	'ɔ:r(ə)l	устный,  словесный,  губной
manner	'mænə	способ,  метод,  манера
pray	preɪ	молиться,  просить
zero	'zɪərəʊ	нуль
pasture	'pɑ:sʧə	пастбище,  корм
act	ækt	дело,  поступок
lose	lu:z	терять (что-л.)
stretch	streʧ	вытягивание,  пространство
explain	ɪk'spleɪn	объяснять
gem	ʤem	драгоценный камень
jaw	ʤɔ:	нижняя челюстная кость,  волна
war	wɔ:	война
rock	rɒk	скала,  утёс,  качать,  трясти
felt	felt	войлок
entertain	,entə'teɪn	принимать,  угощать (гостей)
physics	'fɪzɪks	физика (наука)
move	mu:v	двигать,  переезжать
mast	mɑ:st	мачта
former	'fɔ:mə	создатель,  бывший
banner	bænə	знамя,  флаг
gather	'gæðə	собираться (о людях)
need	ni:d	необходимость,  нуждаться (в чём-л.)
offer	'ɒfə	предлагать
song	sɒŋ	песня
needle	'ni:dl	иголка
charge	ʧɑ:ʤ	заряжать (аккумулятор),  поручать,  назначать цену
pinch	pɪnʧ	щипать,  трудная часть пути
usual	'ju:ʒ(ə)l	обыкновенный,  обычный
grandfather	'græn(d),fɑ:ðə	дедушка
coward	'kaʊəd	трус
army	ɑ:mɪ	армия,  войска
remember	rɪ'membə	помнить
abbey	æbɪ	аббатство,  монастырь
apologize	ə'pɒləʤaɪz	извиняться (за что-л. перед кем-л.)
convenience	kən'vi:nɪən(t)s	удобство
from	frɒm	от, из, с
complain	kəm'pleɪn	жаловаться (на что-л.)
continue	kən'tɪnju:	продолжать
thick	θɪk	толстый,  вязкий (о жидкости)
narrow	'nærəʊ	узкий,  тесный
booth	bu:ð	киоск,  палатка,  будка
forbid	fə'bɪd	запрещать
ardent	ɑ:d(ə)nt	горячий,  пылкий
wrist	rɪst	запястье,  манжета
manual	'mænjʊəl	руководство,  справочник,  учебник
floor	flɔ:	пол,  этаж
upside-down	,ʌpsaɪd'daʊn	перевёрнутый вверх дном
album	ælbəm	альбом
sock	sɒk	носок,  съестное (обычно лакомства)
born	bɔ:n	родившийся,  прирождённый
hunger	'hʌŋgə	голод
poll	pəʊl	список избирателей,  голосование,  аккуратно обрезанный
disgrace	dɪs'greɪs	позор
goat	gəʊt	козёл,  коза,  Козерог
stew	stju:	блюдо из тушёного мяса или рыбы,  тушить,  томить
reduce	rɪ'dju:s	ослаблять,  уменьшать
progress	'prəʊgres	прогресс,  развитие
screen	skri:n	щит,  экран,  защищать
creed	kri:d	вероисповедание
border	bɔ:də	граница
cosy	'kəʊzɪ	уютный,  удобный
holy	'həʊlɪ	святой
nonsense	'nɒns(ə)n(t)s	бессмыслица,  вздор
theft	θeft	воровство
strike	straɪk	ударять,  забастовка
gasp	gɑ:sp	дышать с трудом,  задыхаться
dessert	dɪ'zɜ:t	десерт,  сладкое (блюдо)
success	sək'ses	успех
soul	səʊl	душа
amount	ə'maʊnt	величина,  количество,  сумма
provision	prə'vɪʒ(ə)n	обеспечение,  снабжение
matter	'mætə	вещество,  исходный материал,  гной (мед)
maple	'meɪpl	клён
expire	ɪk'spaɪə	закончиться,  истечь (о сроках)
hold	həʊld	держать,  обнимать
lack	læk	недостаток,  отсутствие (чего-л.)
come	kʌm	приходить,  подходить
news	nju:z	новости
mess	mes	беспорядок,  грязь
grind	graɪnd	молоть,  растирать (в порошок)
blunt	blʌnt	тупой,  непонятливый
amiable	eɪmɪəbl	дружелюбный,  любезный
wrath	rɒθ	гнев,  ярость
wrestle	'resl	бороться
violate	'vaɪəleɪt	нарушать,  применять насилие
virtue	'vɜ:ʧu:	добродетель,  достоинство
honey	'hʌnɪ	мёд,  милый,  льстить
doll	dɒl	кукла (детская игрушка),  наряжать
suggest	sə'ʤest	предлагать,  советовать
wring	rɪŋ	крутить,  скручивать
swing	swɪŋ	качаться,  колебаться
pronounce	prə'naʊn(t)s	объявлять
wholly	'həʊlɪ	полностью,  целиком
blood	blʌd	кровь
drink	drɪŋk	пить
permission	pə'mɪʃ(ə)n	позволение,  разрешение
integral	'ɪntɪgr(ə)l	целый,  неотъемлемый
thought	θɔ:t	мысль,  мышление
consent	kən'sent	согласие
spite	spaɪt	злость
bonfire	bɒn,fa(ɪ)ə	костёр
embarrass	ɪm'bærəs	затруднять,  мешать
billion	bɪlɪən	биллион (миллион миллионов),  амер миллиард (тысяча миллионов)
dignity	'dɪgnətɪ	достоинство,  гордость,  титул
pill	pɪl	пилюля,  таблетка,  грабить,  очищать (кожицу, шелуху)
last	lɑ:st	последний,  прошлый,  продолжаться,  длиться
strong	strɒŋ	сильный
bond	bɒnd	связь, узы (дружбы),  облигации
thursday	'θɜ:zdeɪ	четверг
accept	ək'sept	принимать,  соглашаться
minor	'maɪnə	незначительный,  меньший,  несовершеннолетний
serious	'sɪərɪəs	серьёзный,  важный
malaria	mə'leərɪə	малярия
funny	'fʌnɪ	смешной,  двухвёсельная лодка
winner	'wɪnə	победитель
pea	pi:	горох
statement	'steɪtmənt	заявление,  официальный отчёт
tea	ti:	чай
aggression	ə'greʃ(ə)n	нападение,  агрессия
flatter	'flætə	льстить
vow	vaʊ	клятва,  обет
other	'ʌðə	другой
mutual	'mju:ʧʊəl	взаимный,  обоюдный
decent	'di:s(ə)nt	подходящий,  пристойный
century	'senʧ(ə)rɪ	столетие,  век,  сотня (чего-л.)
victim	'vɪktɪm	живое существо, приносимое в жертву божеству
bar	bɑ:	брусок,  перекладина,  отмель,  препятствие
accent	æks(ə)nt	ударение,  акцент,  стиль
pull	pʊl	тянуть,  тащить
again	ə'gen	ещё,  вновь,  опять
dug	dʌg	сосок (у млекопитающего животного),  вымя
overdue	,əʊvə'dju:	опаздывающий,  просроченный (о долге)
deed	di:d	действие,  деяние
flash	flæʃ	вспышка,  сверкание
history	'hɪst(ə)rɪ	история,  историческая наука
clue	klu:	клубок,  ключ (к разгадке)
cast	kɑ:st	бросать,  состав исполнителей
mice	maɪs	мыши
adviser	əd'vaɪzə	советник,  консультант
language	'læŋgwɪʤ	язык,  речь
negligence	'neglɪʤən(t)s	небрежность,  халатность
zoology	zʊ'ɒləʤɪ	зоология
rich	rɪʧ	богатый,  состоятельный
impulse	'ɪmpʌls	удар,  толчок
bring	brɪŋ	приносить,  привозить
complete	kəm'pli:t	полный,  целый,  завершённый
request	rɪ'kwest	просьба
shop	ʃɒp	магазин,  мастерская
speak	spi:k	говорить
forget	fə'get	забывать о (чём-л.)
cypress	'saɪprəs	кипарис
carrot	kærət	морковь,  рыжие волосы
worm	wɜ:m	червяк,  ползти
crown	kraʊn	корона,  верхушка (чего-л.)
add	æd	прибавлять,  присоединять,  добавлять
bladder	blædə	пузырь,  камера (мяча),  пустомеля
boot	bu:t	ботинок,  сапог,  удар
mute	mju:t	немой
also	ɔ:lsəʊ	тоже,  также
elevate	'elɪveɪt	поднимать
sober	'səʊbə	трезвый,  благоразумный
explore	ɪk'splɔ:	исследовать,  экспериментировать
scissors	'sɪzəz	ножницы
affection	ə'fekʃ(ə)n	любовь,  привязанность,  болезнь
worry	'wʌrɪ	беспокойство,  тревога
overall	'əʊvərɔ:l	полный,  от начала до конца,  рабочий халат
until	(ə)n'tɪl	до,  до тех пор пока
bean	bi:n	боб,  фасоль,  голова,  монета (обычно золотая)
character	kærəktə	характер,  личность,  буква,  клеймо
twelve	twelv	двенадцать
spectacles	'spektəklz	очки
more	mɔ:	более многочисленный,  дополнительный
fling	flɪŋ	бросаться, мчаться
lane	leɪn	узкая дорога
hemisphere	'hemɪsfɪə	полушарие
meter	'mi:tə	измеритель,  счётчик
savage	'sævɪʤ	дикий,  жестокий
deposit	dɪ'pɒzɪt	класть в банк,  отдавать на хранение
brim	brɪm	край,  берег
dry	draɪ	сухой
share	ʃeə	доля,  акция,  лемех
apparatus	,æp(ə)'reɪtəs	прибор,  инструмент,  аппарат
pluck	plʌk	собирать,  срывать,  дёргать
chalk	ʧɔ:k	мел,  долг,  кредит
vase	vɑ:z	ваза
cope	kəʊp	справиться (with),  мантия,  покров
amaze	ə'meɪz	изумлять,  поражать
thumb	θʌm	большой палец (руки)
illiterate	ɪ'lɪt(ə)rət	неграмотный (человек)
flint	flɪnt	кремень
portion	'pɔ:ʃ(ə)n	доза,  порция
shallow	'ʃæləʊ	мелкий,  неглубокий,  поверхностный
spade	speɪd	лопата,  пиковая масть
huge	hju:ʤ	большой,  огромный
pick	pɪk	кирка,  зубочистка,  срывать (цветы),  выбирать
gradual	'grædjʊəl	постепенный,  последовательный
hostile	'hɒstaɪl	вражеский,  враждебный
metropolitan	,metrə'pɒlɪt(ə)n	столичный,  центральный
enterprise	'entəpraɪz	смелое предприятие,  инициатива
inscription	ɪn'skrɪpʃ(ə)n	надпись
lean	li:n	тощий,  худой,  наклонять,  нагибать
waltz	wɒl(t)s	вальс,  легко осуществлять (что-л.)
spring	sprɪŋ	весна,  пружина,  источник,  прыгать
endure	ɪn'djʊə	вынести,  вытерпеть
proud	praʊd	гордый
our	'aʊə	наш
yesterday	'jestədeɪ	вчера
grasp	grɑ:sp	крепкое сжатие,  рукоятка
goose	gu:s	гусь
trade	treɪd	ремесло,  торговля
incredible	ɪn'kredɪbl	маловероятный
benevolence	bɪ'nevələn(t)s	доброжелательность,  благотворительность
rank	ræŋk	ряд,  линия,  звание,  чин
always	ɔ:lweɪz	всегда
zealous	'zeləs	рьяный,  усердный
sketch	skeʧ	эскиз,  набросок
uneasy	ʌn'i:zɪ	неловкий,  неудобный
etching	'eʧɪŋ	гравюра
antarctic	ænt'ɑ:ktɪk	Антарктика
loose	lu:s	свободный,  неприкреплённый
high	haɪ	высокий
primitive	'prɪmɪtɪv	первобытный,  примитивный
admission	əd'mɪʃ(ə)n	вход,  принятие,  приём (в учебное заведение)
full	fʊl	полный,  целый
elastic	ɪ'læstɪk	эластичный,  гибкий,  резинка (шнур)
outcome	'aʊtkʌm	итог,  результат
overthrow	,əʊvə'θrəʊ	бросать слишком далеко
royal	'rɒɪəl	царский,  королевский
plant	plɑ:nt	растение,  сажать,  завод
differ	'dɪfə	отличаться (от кого-л. в чём-л.)
date	deɪt	дата,  свидание,  финик
waste	weɪst	растрата,  потеря
safety	'seɪftɪ	безопасность
stage	steɪʤ	сцена,  стадия,  этап
rely	rɪ'laɪ	полагаться,  быть уверенным (в чём-л.)
spot	spɒt	пятно,  капля
big	bɪg	большой,  крупный,  = big with  наполненный
investment	ɪn'vestmənt	инвестирование,  вложение денег
unless	ən'les, ʌn'les	если не,  кроме
offend	ə'fend	действовать против чего-л,  обижать
line	laɪn	линия,  верёвка,  провод
attractive	ə'træktɪv	привлекательный
arrogance	ærəgən(t)s	высокомерие,  надменность
bury	berɪ	хоронить,  предавать земле
time	taɪm	время
candle	kændl	свеча
drove	drəʊv	стадо,  толпа,  ехал
flow	fləʊ	течение,  поток
attract	ə'trækt	притягивать,  привлекать (внимание)
warn	wɔ:n	предупреждать
elbow	'elbəʊ	локоть,  толкаться локтями
worth	wɜ:θ	ценность,  значение,  случаться,  происходить
unintentional	,ʌnɪn'ten(t)ʃ(ə)n(ə)l	непреднамеренный,  нечаянный
abroad	ə'brɔ:d	за границей,  широко,  повсюду
mustard	'mʌstəd	горчица
just	ʤʌst	справедливый,  точно
weep	wi:p	плакать
smart	smɑ:t	сильная боль,  энергичный,  ловкий
crime	kraɪm	преступление,  обвинять
behave	bɪ'heɪv	вести себя,  поступать
artistic	ɑ:'tɪstɪk	артистический,  художественный
crab	kræb	краб,  царапать
spoon	spu:n	ложка,  (романтично) ухаживать
beside	bɪ'saɪd	рядом с,  близ,  около
owe	əʊ	быть должным (кому-л.)
dedicate	'dedɪkeɪt	посвящать (себя чему-л.) (to)
library	'laɪbr(ə)rɪ	библиотека
pipe	paɪp	(курительная) трубка,  свирель,  трубопровод
pear	peə	груша
wedding	'wedɪŋ	свадьба
undying	ʌn'daɪɪŋ	бессмертный
insist	ɪn'sɪst	настаивать на
uncle	'ʌŋkl	дядя
attach	ə'tæʧ	прикреплять,  приклеивать
foreword	'fɔ:wɜ:d	введение,  предисловие
arrest	ə'rest	арестовывать, задерживать (for, on charges of)
interrupt	,ɪntə'rʌpt	прерывать,  внезапно прекращать
beaver	bi:və	бобр,  забрало
arrival	ə'raɪv(ə)l	прибытие (at, in, from)
greet	gri:t	приветствовать,  здороваться,  встречать
length	leŋ(k)θ	длина
long	lɒŋ	длинный,  долгий,  страстно желать (чего-л.)
fold	fəʊld	сгибать,  складывать
accident	æksɪd(ə)nt	несчастный случай,  катастрофа,  авария
root	ru:t	корень,  нижняя часть
ample	æmpl	богатый,  обильный,  просторный
fell	fel	шкура,  холм,  свирепый,  рубить (дерево)
oppress	ə'pres	подавлять,  притеснять
longitude	'lɒnʤɪtju:d	долгота (геогр)
real	rɪəl	реальный,  подлинный
along	ə'lɒŋ	вдоль,  в соответствии
prejudice	'preʤədɪs	предубеждение,  предрассудок
bus	bʌs	автобус
cup	kʌp	чашка
traffic	'træfɪk	движение,  транспорт
positive	'pɒzətɪv	позитивный,  реальный,  положительный
sweet	swi:t	сладкий (о вкусе),  конфета
concern	kən'sɜ:n	деловые отношения,  интерес,  участие
leap-year	'li:pjɪə	високосный год
polish	'pɒlɪʃ	глянец,  блеск,  полировка
sanitary	'sænɪt(ə)rɪ	санитарный,  гигиенический
janitor	'ʤænɪtə	вахтёр,  швейцар
ski	ski:	лыжа,  ходить на лыжах
arm-chair	ɑ:mʧeə	кресло
virgin	'vɜ:ʤɪn	дева,  девственница
clip	klɪp	скрепка,  зажим,  обрезать,  стрижка
stare	steə	пристально глядеть
adapt	ə'dæpt	приспосабливать
fault	fɔ:lt	дефект,  ошибка
namely	'neɪmlɪ	а именно,  то есть
call-box	'kɔ:lbɒks	телефонная будка
badger	bæʤə	барсук,  шантажист,  дразнить
pact	pækt	договор
lining	'laɪnɪŋ	внутренняя обивка,  выпрямление,  выравнивание
cutter	'kʌtə	резчик (по дереву, камню),  скульптор
fool	fu:l	дурак,  шут
afterwards	ɑ:ftəwədz	впоследствии,  после,  потом
bent	bent	наклонность,  склонность,  прош.вр. - bend сгибать
spider	'spaɪdə	паук,  сковорода с ручкой
appetite	æpɪtaɪt	аппетит
blazer	bleɪzə	блейзер (пиджак спортивного покроя),  нечто сияющее
bottle	bɒtl	бутылка
negotiate	nɪ'gəʊsɪeɪt	вести переговоры,  торговать (чем-л.)
assemble	ə'sembl	собирать,  созывать
dare	deə	отваживаться,  пренебрегать опасностью
riddle	'rɪdl	загадка,  решето,  просеивать (через сито)
crew	kru:	экипаж (судна)
idle	'aɪdl	ленивый,  бесполезный
evil	'i:v(ə)l	зло,  вред
block	blɒk	глыба,  препятствие,  квартал,  группа однородных предметов
insect	'ɪnsekt	насекомое
contain	kən'teɪn	содержать в себе
slice	slaɪs	ломтик,  тонкий слой
kidney	'kɪdnɪ	почка (анатом),  характер
prove	pru:v	доказывать
giant	'ʤaɪənt	великан,  гигант
booklet	bʊklɪt	брошюра,  буклет
bloom	blu:m	цвет,  цветение
fill	fɪl	наполнять,  достаточное количество чего-л.
poison	'pɒɪz(ə)n	яд
voice	vɒɪs	голос
confer	kən'fɜ:	давать (кому-л.) (on),  обсуждать (with)
convention	kən'ven(t)ʃ(ə)n	собрание,  съезд,  соглашение
bad	bæd	плохой
experience	ɪk'spɪərɪən(t)s	(жизненный) опыт,  случай
cutlet	'kʌtlət	отбивная котлета
generous	'ʤen(ə)rəs	великодушный,  щедрый
arctic	ɑ:ktɪk	арктический,  ледяной
gang	gæŋ	набор (инструментов),  группа людей
benefit	benɪfɪt	выгода,  польза,  пенсия
headquarters	,hed'kwɔ:təz	главный орган управления,  штаб
unskilled	ʌn'skɪld	неквалифицированный,  необученный
dead	ded	мёртвый
verse	vɜ:s	поэзия,  стихи
as	æz	в качестве,  как,  в равной степени
wc	,dʌblju:'si:	туалет, сокращ. от water closet
exclude	ɪks'klu:d	исключать,  не допускать (возможности и т. п.)
heal	hi:l	вылечивать
control	kən'trəʊl	руководство,  управление,  власть
steady	'stedɪ	устойчивый,  прочный
peach	pi:ʧ	персик,  ябедничать
petrol	'petr(ə)l	бензин,  моторное топливо
purchase	'pɜ:ʧəs	покупка,  стоимость
session	'seʃ(ə)n	заседание,  собрание
pang	pæŋ	внезапная острая боль
urban	'ɜ:b(ə)n	городской
engineer	,enʤɪ'nɪə	инженер,  конструктор
juice	ʤu:s	сок,  сущность (чего-л.)
city	sɪtɪ	большой город
notorious	nəʊ'tɔ:rɪəs	пользующийся дурной славой
affirm	ə'fɜ:m	подтверждать,  утверждать
rude	ru:d	грубый,  невежливый
inner	'ɪnə	внутренний
caution	'kɔ:ʃ(ə)n	осмотрительность,  осторожность
bulletin	bʊlɪtɪn	бюллетень,  краткое официальное сообщение
speech	spi:ʧ	речь,  выступление
person	'pɜ:s(ə)n	человек,  личность
jug	ʤʌg	кувшин,  щёлканье (обычно соловья)
sit	sɪt	сидеть
roll	rəʊl	катиться,  вертеться
plump	plʌmp	полный,  обильный,  прямой,  решительный
fame	feɪm	известность,  слава
talk	tɔ:k	говорить
squeeze	skwi:z	сжимать
corner	'kɔ:nə	угол,  перекрёсток (улиц, дорог)
exchange	ɪks'ʧeɪnʤ	обмен,  биржа
coincide	,kəʊɪn'saɪd	совпадать
tulip	'tju:lɪp	тюльпан
wrinkle	'rɪŋkl	морщина,  складка,  трудность
coast	kəʊst	морское побережье,  курсировать
perfect	'pɜ:fɪkt	совершенный,  идеальный,  законченный
pole	pəʊl	столб,  шест,  полюс
cane	keɪn	тростник,  камыш
inquire	ɪn'kwaɪə	спрашивать,  искать
omission	ə'mɪʃ(ə)n	недосмотр,  ошибка
friend	frend	друг,  помогать
lantern	'læntən	фонарь,  свет
weigh	weɪ	взвешивать,  весить
local	'ləʊk(ə)l	местный (связанный с определённым местом)
adequate	ædɪkwət	адекватный,  соответствующий,  достаточный
steward	'stju:əd	официант,  управляющий
island	'aɪlənd	остров
prefer	prɪ'fɜ:	предпочитать
litter	'lɪtə	разбросанные вещи,  беспорядок
drill	drɪl	дрель,  сверло,  тренировка
hog	hɒg	свинья,  выгибать спину вверх (как животные)
mike	maɪk	слоняться,  бездельничать
radical	'rædɪk(ə)l	корень (чего-л.),  основной принцип
volcano	vɒl'keɪnəʊ	вулкан
plane	pleɪn	плоскость,  рубанок,  платан
hell	hel	ад,  преисподняя
errand	'erənd	поручение,  задание
merit	'merɪt	заслуга
elect	ɪ'lekt	избирать (голосованием)
special	'speʃ(ə)l	особый,  специальный
smile	smaɪl	улыбка
draught	drɑ:ft	сквозняк,  шашки (игра)
against	ə'gen(t)st	против,  лицом к,  рядом
shirt	ʃɜ:t	рубашка
brow	braʊ	бровь,  лоб,  выражение лица
mind	maɪnd	разум
dire	'daɪə	страшный
knowledge	'nɒlɪʤ	познания,  эрудиция
boundary	baʊnd(ə)rɪ	граница,  межа
origin	'ɒrɪʤɪn	начало,  источник
quiet	'kwaɪət	тихий,  спокойный
cuff	kʌf	манжета,  наручники,  бить (кулаком)
duty	'dju:tɪ	уважение,  повиновение
basin	beɪsn	миска,  таз
whose	hu:z	чей,  чьё
promise	'prɒmɪs	обещание
doom	du:m	судьба,  гибель
exaggerate	ɪg'zæʤəreɪt	преувеличивать,  усложнять
frost	frɒst	мороз,  иней
float	fləʊt	плавать
present	'prez(ə)nt	настоящее время,  присутствующий,  подарок
motion	'məʊʃ(ə)n	движение
australian	ɒs'treɪlɪən	австралийский
shrink	ʃrɪŋk	уменьшать
throw	θrəʊ	бросать,  кидать
themselves	ðəm'selvz	себя,  себе
counter	'kaʊntə	тот кто считает,  прилавок
shine	ʃaɪn	светить,  сиять
brilliant	brɪlɪənt	бриллиант,  блестящий
hop	hɒp	прыжок,  хмель (бот)
explosion	ɪk'spləʊʒ(ə)n	взрыв,  взрывание
disapprove	,dɪsə'pru:v	не одобрять,  осуждать (что-л.)
badge	bæʤ	эмблема,  значок
april	eɪpr(ə)l	апрель
street	stri:t	улица
living	'lɪvɪŋ	средства к существованию,  образ жизни
available	ə'veɪləbl	доступный,  имеющийся в распоряжении
fancy	'fæn(t)sɪ	воображение,  фантазия
outlook	'aʊtlʊk	точка зрения,  перспектива
withdraw	wɪð'drɔ:	отодвигать,  отдёргивать
sparse	spɑ:s	разбросанный,  редкий
stuff	stʌf	вещество (из чего что-л. состоит),  набивать,  запихивать
quake	kweɪk	трястись,  дрожать
fog	fɒg	туман,  затруднение
succeed	sək'si:d	следовать за (кем-л.),  сменять (кого-л.)
current	'kʌr(ə)nt	струя,  поток,  течение
subway	'sʌbweɪ	тоннель,  метро
secretary	'sekrət(ə)rɪ	секретарь,  помощник
sick	sɪk	больной,  натравливать (собаку на кого-л.)
capital	kæpɪtəl	капитал,  столица,  заглавный (о букве)
newly	'nju:lɪ	заново
fertile	'fɜ:taɪl	плодородный
knight	naɪt	рыцарь
rest	rest	отдыхать
prison	'prɪz(ə)n	тюрьма
scorn	skɔ:n	презрение,  насмешка
cemetery	'semətrɪ	кладбище
barrister	bærɪstə	адвокат
legacy	'legəsɪ	наследство
define	dɪ'faɪn	давать определение (какому-л. понятию) (as)
story	'stɔ:rɪ	повесть,  рассказ
tent	tent	палатка,  тампон
cashier	kæ'ʃɪə	кассир,  увольнять со службы
chairman	'ʧeəmən	председатель
folk	fəʊk	люди,  народ
occur	ə'kɜ:	происходить,  случаться
courage	'kʌrɪʤ	бесстрашие,  мужество
splendid	'splendɪd	роскошный
misery	'mɪz(ə)rɪ	страдание,  несчастье
forehead	'fɔ:hed	лоб
foul	faʊl	грязный
intend	ɪn'tend	намереваться
novel	'nɒv(ə)l	роман,  новый
binding	baɪndɪŋ	связывание,  скрепление,  переплёт (книги)
improbable	ɪm'prɒbəbl	невероятный,  неправдоподобный
jelly	'ʤelɪ	желе
basement	beɪsmənt	основание,  фундамент,  подвал
laurel	'lɒr(ə)l	лавр благородный
fade	feɪd	увядать (о растениях),  выцветать
over	'əʊvə	над,  выше
pressing	'presɪŋ	обременительный,  неотложный
signal	'sɪgn(ə)l	знак,  сигнал,  подавать сигнал
inclination	,ɪnklɪ'neɪʃ(ə)n	наклон,  отклонение
descent	dɪ'sent	спуск,  снижение
thirteen	θɜ:'ti:n	тринадцать
strive	straɪv	стараться,  пытаться
attention	ə'ten(t)ʃ(ə)n	внимание,  внимательность
thin	θɪn	тонкий,  жидкий
mention	'menʃ(ə)n	упоминание,  ссылка (на что-л. / кого-л.)
fur	fɜ:	мех,  одежда из меха
ashamed	ə'ʃeɪmd	пристыженный
swear	sweə	клятва
rain	reɪn	дождь
mint	mɪnt	мята,  монетный двор,  новый только что выпущенный
made	meɪd	сделанный искусственно,  выдуманный
choose	ʧu:z	выбирать
authorize	ɔ:θ(ə)raɪz	уполномочивать,  поручать
cucumber	'kju:kʌmbə	огурец
freight	freɪt	фрахт,  плата за перевозку грузов
retire	rɪ'taɪə	уходить в отставку,  на пенсию
pit	pɪt	яма
bust	bʌst	бюст (скульптурное изображение до пояса),  неудача
mighty	'maɪtɪ	могущественный,  большой (о размерах)
abbreviation	ə,bri:vɪ'eɪʃ(ə)n	сокращение, урезание (текста при письме),  аббревиатура
battle	bætl	сражение,  армия
bleeding	bli:dɪŋ	кровотечение
misunderstand	,mɪsʌndə'stænd	неправильно понять
iron	'aɪən	железо
kindergarten	'kɪndə,gɑ:t(ə)n	детский сад
quick	kwɪk	быстрый
peninsula	pə'nɪn(t)sjələ	полуостров
cord	kɔ:d	верёвка,  связь
conquer	'kɒŋkə	завоёвывать,  покорять
badminton	bædmɪntən	бадминтон
corn	kɔ:n	зерно,  зёрнышко (хлебных злаков)
allowance	ə'laʊən(t)s	денежное пособие,  карманные деньги,  норма выдачи
lock	lɒk	локон,  листва деревьев,  замок
tomorrow	tə'mɒrəʊ	завтра
crow	krəʊ	ворона,  карканье
biography	baɪ'ɒgrəfɪ	биография
scholar	'skɒlə	учёный (гуманитарий),  филолог,  ученик
enter	'entə	входить
gallery	'gæl(ə)rɪ	галерея,  место для прогулок
dustbin	'dʌstbɪn	мусорный ящик
hijack	'haɪʤæk	нападать с целью грабежа
altar	ɔ:ltə	алтарь,  священное место
vote	vəʊt	голосование,  право голоса
cake	keɪk	пирожное,  торт,  затвердевать
tie	taɪ	лента,  галстук-бабочка,  завязывать
pity	'pɪtɪ	жалеть,  соболезновать
front	frʌnt	лоб,  фасад,  передняя сторона чего-л
inn	ɪn	жильё,  гостиница
bread	bred	хлеб
rage	reɪʤ	ярость
liar	'laɪə	лгун
shadow	'ʃædəʊ	тень,  пятно
fee	fi:	вознаграждение,  гонорар (за какие-либо услуги)
walk	wɔ:k	идти,  гулять
co-operate	kəʊ'ɒp(ə)reɪt	сотрудничать с кем-л.,  объединяться с кем-л.
tall	tɔ:l	высокий
distrust	dɪs'trʌst	недоверие,  сомнение
figure	'fɪgə	фигура (человека),  телосложение,  внешний вид
pack	pæk	пачка,  куча
voluntary	'vɒlənt(ə)rɪ	добровольный,  бесплатный
secure	sɪ'kjʊə	безопасный,  надёжный
cellar	'selə	подвал
bourgeois	bʊəʒwɑ:	буржуа,  капиталистический
discourage	dɪs'kʌrɪʤ	лишать мужества,  уверенности в себе
damage	'dæmɪʤ	вред,  повреждение
among	ə'mʌŋ	между,  среди
slow	sləʊ	медленный
brutal	bru:tl	бесчеловечный,  жестокий
bowl	bəʊl	кубок,  чаша,  шар,  изгибаться
fist	fɪst	кулак,  рукопожатие
glove	glʌv	перчатка
lizard	'lɪzəd	ящерица
museum	mju:'zi:əm	музей
lodger	'lɒʤə	жилец,  квартирант
knee	ni:	колено
farther	'fɑ:ðə	отдалённый,  удалённый  (от far)
creak	kri:k	скрип
want	wɒnt	недостаток,  нехватка (чего-л.),  разыскивать (о преступнике)
offence	ə'fen(t)s	нарушение чего-л.,  обида,  оскорбление
valley	'vælɪ	долина
compel	kəm'pel	заставлять
bathe	beɪð	купание
buffalo	bʌfələʊ	буйвол,  пугать,  обманывать
beastly	bi:stlɪ	животный,  грубый
gland	glænd	железа
attendant	ə'tendənt	обслуживающее лицо,  сопровождающее лицо
theatre	'θɪətə	театр
dream	dri:m	сон,  мечта
try	traɪ	пытаться,  стараться
have	hæv	иметь,  обладать
applied	ə'plaɪd	практический,  прикладной
found	faʊnd	основывать,  плавить (металл)
lecture	'lekʧə	лекция,  наставление
saddle	'sædl	седло
common	'kɒmən	общий
convince	kən'vɪn(t)s	убеждать
ladder	'lædə	лестница,  спустившаяся петля (на чулке)
rattle	'rætl	треск,  грохот,  детская погремушка
free	fri:	свободный
hatred	'heɪtrɪd	ненависть
knit	nɪt	вязать,  хмурить (брови),  соединять
pants	pænts	брюки,  штаны
stress	stres	давление,  нажим
absurd	əb'sɜ:d	нелепый,  абсурдный,  смешной
badly	bædlɪ	плохо
barbecue	bɑ:bɪkju:	целиком зажаренная туша
baggage	bægɪʤ	багаж
frown	fraʊn	смотреть неодобрительно,  хмурить брови
built	bɪlt	прош. вр. build - строить
toe	təʊ	палец ноги
gate	geɪt	ворота,  дверь
fruit	fru:t	плод,  фрукт
turtle	'tɜ:tl	черепаха
uncertain	ʌn'sɜ:t(ə)n	неопределённый,  неясный
obtain	əb'teɪn	получать,  приобретать
gutter	'gʌtə	бороздка (проделанная водой),  водосточный жёлоб
blonde	blɒnd	блондинка
discontent	,dɪskən'tent	недовольство,  неудовлетворённость
indicate	'ɪndɪkeɪt	показывать,  указывать
amusement	ə'mju:zmənt	изумление,  забава
harsh	hɑ:ʃ	жёсткий,  твёрдый
ate	et	прош. вр eat  есть,  поглощать
disrupt	dɪs'rʌpt	разорванный (на части)
manage	'mænɪʤ	руководить,  управлять
heel	hi:l	пятка,  преследовать,  наклон
archery	ɑ:ʧərɪ	стрельба из лука
oath	əʊθ	клятва,  присяга
replace	rɪ'pleɪs	заменять
clever	klevə	умный,  проворный
happy	'hæpɪ	счастливый,  довольный
injure	'ɪnʤə	ранить,  испортить
depress	dɪ'pres	подчинять,  подавлять,  ослаблять
pine	paɪn	сосна,  чахнуть,  жаждать (чего-л.)
frustrate	frʌs'treɪt	срывать (планы),  мешать
develop	dɪ'veləp	развивать,  совершенствовать
market	'mɑ:kɪt	базар,  рынок
claim	kleɪm	требование,  иск
frame	freɪm	рама,  каркас,  собирать (конструкцию)
slang	slæŋ	сленг,  длинная узкая полоска земли,  цепочка для часов
social	'səʊʃ(ə)l	общественный,  социальный,  встреча (членов общества)
importance	ɪm'pɔ:t(ə)n(t)s	важность,  значимость
dance	dɑ:n(t)s	танцевать
cause	kɔ:z	причина
typist	'taɪpɪst	машинистка,  наборщик
apple	æp(ə)l	яблоко
bandage	bændɪʤ	бинт,  повязка (на глаза)
chase	ʧeɪs	гнаться,  охотиться,  вырезать орнамент
defect	dɪ'fekt	неисправность,
certificate	sə'tɪfɪkət	документ,  свидетельство
alto	æltəʊ	альт (голос и музыкальный инструмент)
lawn	lɔ:n	батист,  газон
width	wɪtdθ	ширина
gift	gɪft	подарок,  талант
insignificant	,ɪnsɪg'nɪfɪk(ə)nt	незначительный,  несущественный
deduct	dɪ'dʌkt	вычитать,  отнимать
dip	dɪp	макать,  окунать,  нырять
notify	'nəʊtɪfaɪ	извещать,  уведомлять
bat	bæt	летучая мышь (Vespertilio murinus),  палка,  моргать,  войлок
awake	ə'weɪk	будить,  проснуться
forge	fɔ:ʤ	выковывать,  выдумывать
apricot	eɪprɪkɒt	абрикос (плод)
compete	kəm'pi:t	состязаться,  соревноваться
drag	dræg	тянуть,  тащить
queer	kwɪə	странный,  подозрительный
decorate	'dek(ə)reɪt	украшать
embody	ɪm'bɒdɪ	воплощать (в себе),  изображать
chapel	'ʧæp(ə)l	часовня,  хор певчих
chamber	'ʧeɪmbə	комната
card	kɑ:d	карта,  билет
obstacle	'ɒbstəkl	помеха,  препятствие
gum	gʌm	десна,  смола,  резина
gentle	ʤentl	благородный,  добрый
backwards	bækwədz	прошлое,  отсталый,  назад
burnt	bɜ:nt	горелый,  жжёный,  прош.вр. burn - гореть
conversation	,kɒnvə'seɪʃ(ə)n	разговор,  беседа
distort	dɪ'stɔ:t	искажать,  искривлять
question	'kwesʧən	вопрос
kick	kɪk	ударять ногой,  пинать
remove	rɪ'mu:v	перемещать
mason	'meɪs(ə)n	каменщик,  масон
observatory	əb'zɜ:vətrɪ	обсерватория,  наблюдательный пункт
resemble	rɪ'zembl	походить,  иметь сходство
queue	kju:	коса,  заплетать,  очередь
several	'sev(ə)r(ə)l	несколько
gospel	'gɒsp(ə)l	Евангелие
spoil	spɒɪl	трофеи,  мародёрство
defeat	dɪ'fi:t	поражение,  проигрыш (в соревновании)
sequence	'si:kwən(t)s	последовательность,  последствие,  итог
display	dɪs'pleɪ	показ,  выставка
alien	eɪlɪən	иностранец,  внешний
assertion	ə'sɜ:ʃ(ə)n	утверждение,  претензия
luck	lʌk	фортуна,  счастливый случай
clerk	klɑ:k	офисный служащий,  клерк
omit	ə'mɪt	пропускать,  пренебрегать (чем-л.)
brook	brʊk	ручей,  терпеть
hook	hʊk	крючок,  приманка
spoke	spəʊk	спица (колеса),  луч (света)
upper	'ʌpə	верхний,  расположенный наверху
attack	ə'tæk	атаковать,  критиковать
save	seɪv	спасать,  экономить
effect	ɪ'fekt	результат,  следствие
task	tɑ:sk	урок,  задать работу
bell	bel	колокол,  звонок
grace	greɪs	грация,  изящество,  вежливость
basis	beɪsɪs	базис,  основание,  фундамент
extend	ɪk'stend	распространять влияние,  простираться
buckwheat	bʌkwi:t	гречиха
beech	bi:ʧ	бук (дерево)
flexible	'fleksəbl	гибкий
emotion	ɪ'məʊʃ(ə)n	душевное волнение,  чувство
ambiguous	æm'bɪgjʊəs	двусмысленный,  сомнительный
feed	fi:d	кормить,  пасти (скот)
conceal	kən'si:l	скрывать,  утаивать
camera	kæm(ə)rə	фотоаппарат,  сводчатое помещение
cot	kɒt	койка,  загон,  футляр
collect	kə'lekt	собирать,  комплектовать
mud	mʌd	грязь,  ил,  тина
apology	ə'pɒləʤɪ	извинение
still	stɪl	бесшумный,  тихий,  до сих пор,  дистиллятор
cricket	'krɪkɪt	сверчок,  крикет,  табурет
true	tru:	верный,  правильный
wisdom	'wɪzdəm	мудрость
journal	'ʤɜ:n(ə)l	дневник,  ежедневная газета
bitter	bɪtə	горький,  злой,  сильный (морозе)
east	i:st	восток
beneficial	,benɪ'fɪʃ(ə)l	благотворный,  целебный
perfume	'pɜ:fju:m	аромат,  духи
pretend	prɪ'tend	притворяться,  делать вид,  претендовать
umbrella	ʌm'brelə	зонт
people	'pi:pl	люди,  народ
afraid	ə'freɪd	испуганный,  боящийся
hit	hɪt	ударять (по чему-л.)
wide	waɪd	широкий
body	bɒdɪ	тело (человека или животного)
hair	heə	волосы
false	fɔ:ls	неверный,  ошибочный
read	ri:d	читать
hang	hæŋ	висеть
amplifier	æmplɪfaɪə	усилитель
constellation	,kɒn(t)stə'leɪʃ(ə)n	созвездие
fluent	'flu:ənt	текучий,  текущий
carriage	kærɪʤ	коляска,  карета,  вагон
dish	dɪʃ	блюдо,  кушанье,  посуда
accordance	ə'kɔ:d(ə)n(t)s	согласие,  соответствие
lather	'lɑ:ðə	пена (от моющего средства)
cattle	'kætl	крупный рогатый скот
bathing	beɪðɪŋ	купание
grave	greɪv	могила,  вырезать, гравировать,  серьёзный, важный
odour	'əʊdə	запах (обычно неприятный)
bud	bʌd	почка,  бутон,  зародыш
introduce	,ɪntrə'dju:s	вставлять,  знакомить
lorry	'lɒrɪ	грузовой автомобиль,  вагонетка
march	mɑ:ʧ	граница,  марш
neighbour	'neɪbə	сосед
ratio	'reɪʃɪəʊ	отношение,  пропорция
summary	'sʌm(ə)rɪ	краткое изложение
confirm	kən'fɜ:m	подтверждать,  одобрять
junior	'ʤu:nɪə	младший (по возрасту)
alliance	ə'laɪən(t)s	союз,  альянс
sentiment	'sentɪmənt	чувство,  сентиментальность
brick	brɪk	кирпич,  буханка
beneath	bɪ'ni:θ	внизу,  ниже
second	'sek(ə)nd	секунда,  второй
truck	trʌk	грузовой автомобиль,  обмен
china	ʧaɪnə	фарфор
axe	æks	топор
murder	'mɜ:də	убийство
industrious	ɪn'dʌstrɪəs	прилежный,  трудолюбивый
button	bʌtn	пуговица,  кнопка
wednesday	'wenzdeɪ	среда (день недели)
chopper	'ʧɒpə	нож (мясника)
pride	praɪd	гордость,  прайд, стая львов
dean	di:n	декан,  настоятель собора,  узкая долина
perform	pə'fɔ:m	исполнять,  выполнять
outside	,aʊt'saɪd	внешняя, наружная часть
hut	hʌt	лачуга,  хижина
neutral	'nju:tr(ə)l	нейтральный
review	rɪ'vju:	обзор,  рецензия,  периодический журнал
cliff	klɪf	отвесная скала на берегу моря,  утёс
announce	ə'naʊn(t)s	объявлять,  извещать
kind	kaɪnd	сорт,  добрый
small	smɔ:l	маленький
many	'menɪ	много
engage	ɪn'geɪʤ	привлекать,  заинтересовывать
resume	rɪ'zju:m	возобновлять,  продолжать (после перерыва)
hard	hɑ:d	твёрдый,  крепкий
atom	ætəm	атом
vanity	'vænətɪ	суета,  тщеславие
hedge	heʤ	(живая) изгородь
envy	'envɪ	зависть
notice	'nəʊtɪs	сообщение,  объявление
stammer	'stæmə	заикаться
agree	ə'gri:	соглашаться
terrible	'terəbl	ужасный
son	sʌn	сын
number	'nʌmbə	число,  сумма,  цифра
early	'ɜ:lɪ	рано
reserve	rɪ'zɜ:v	запасать,  откладывать
depot	'depəʊ	склад,  хранилище,  станция
merry	'merɪ	весёлый,  радостный,  черешня
least	li:st	минимальный,  наименьший
monkey	'mʌŋkɪ	обезьяна
melon	'melən	дыня
determine	dɪ'tɜ:mɪn	определять,  решать
mood	mu:d	настроение,  наклонение (лингв)
jail	ʤeɪl	тюрьма
anybody	enɪ,bɒdɪ	кто-нибудь
bed	bed	кровать,  клумба,  дно (моря)
celebrate	seləbreɪt	праздновать
superior	su:'pɪərɪə	высший,  лучший,  начальник,  старший
outline	'aʊtlaɪn	очертание,  эскиз
mock	mɒk	высмеивание,  подражание
kettle	'ketl	чайник
dusk	dʌsk	сумерки,  полумрак
run	rʌn	бежать
appropriate	ə'prəʊprɪət	подходящий,  свойственный
skill	skɪl	искусство,  мастерство
vague	veɪg	неопределённый,  неясный
pigeon	'pɪʤən	голубь
untie	ʌn'taɪ	развязывать
brake	breɪk	тормоз,  большая борона,  кустарник,  чаща
shake	ʃeɪk	трясти
difficult	'dɪfɪk(ə)lt	трудный
only	'əʊnlɪ	только,  единственный
fair	feə	ярмарка,  красивый
seldom	'seldəm	редко
undress	ʌn'dres	домашний костюм,  раздевать
appendix	ə'pendɪks	добавление,  дополнение
ambulance	æmbjələn(t)s	полевой госпиталь,  машина скорой помощи
overtake	,əʊvə'teɪk	догнать,  обогнать,  случаться внезапно
particular	pə'tɪkjʊlə	редкий,  специфический,  частность,  деталь
advance	əd'vɑ:n(t)s	движение вперёд,  успех
identify	aɪ'dentɪfaɪ	отождествлять (что-л.) с (чем-л.),  опознавать
some	sʌm	кое-кто,  некоторое количество (чего-л.)
liberal	'lɪb(ə)r(ə)l	свободомыслящий,  прогрессивный
refuge	'refju:ʤ	убежище,  спасение
necessary	'nesəs(ə)rɪ	необходимый
apprentice	ə'prentɪs	подмастерье,  ученик (в ремесле)
expect	ɪk'spekt	ожидать,  надеяться
notion	'nəʊʃ(ə)n	идея,  мнение,  упоминание
drum	drʌm	барабан
mother-in-law	'mʌð(ə)rɪn,lɔ:	тёща,  свекровь
shoe	ʃu:	туфля,  обувать
fir	fɜ:	ель (и другие виды хвойных деревьев)
challenge	ʧælɪnʤ	вызов,  сложная задача,  ставить под сомнение
red	red	красный
seal	si:l	тюлень,  печать,  клеймо
total	'təʊt(ə)l	весь,  целый
around	ə'raʊnd	вокруг,  повсюду
brush	brʌʃ	щётка,  густой кустарник,  захолустье
pencil	'pen(t)s(ə)l	карандаш,  кисть (живописца)
exile	'eksaɪl	изгнание,  худой,  тощий
exhibit	ɪg'zɪbɪt	экспонат (на выставке),  выставка
low	ləʊ	мычание
biology	baɪ'ɒləʤɪ	биология
black	blæk	чёрный,  сердитый
grove	grəʊv	лесок,  роща
american	ə'merɪkən	американский
modern	'mɒd(ə)n	современный,  новый
couch	kaʊʧ	диван,  кушетка
what	(h)wɒt	что?  какой?   какого рода?
hunt	hʌnt	охота,  ловля
boast	bəʊst	хвастовство,  предмет гордости,  обтёсывать камень
view	vju:	вид,  пейзаж,  осмотр
constitution	,kɒn(t)stɪ'tju:ʃ(ə)n	учреждение,  основной закон,  телосложение
adjourn	ə'ʤɜ:n	откладывать,   прерывать,  переносить
hinder	'haɪndə	задний,  задерживать,  мешать
brother-in-law	brʌð(ə)rɪn,lɔ:	зять (муж сестры),  шурин (брат жены)
tiger	'taɪgə	тигр
confess	kən'fes	признавать,  признаваться
plaid	plæd	плед,  рисунок в клетку
twilight	'twaɪlaɪt	сумерки,  неясность (чего-л.)
sight	saɪt	зрение,  зрелище
law	lɔ:	закон (регулирующий, предписывающий акт)
lend	lend	одалживать,  давать взаймы
lot	lɒt	жребий,  судьба,  участок земли
chapter	ʧæptə	глава (книги),  период
earthquake	'ɜ:θkweɪk	землетрясение
draft	drɑ:ft	набросок,  чертёж
smooth	smu:ð	гладкий,  ровный
can	kæn	мочь,  жестяная банка,  консервировать (продукты)
aesthetics	i:s'θetɪks	эстетика
below	bɪ'ləʊ	внизу,  ниже
marriage	'mærɪʤ	брак,  супружество
accuse	ə'kju:z	обвинять,  упрекать
deliver	dɪ'lɪvə	доставлять,  разносить
silence	'saɪlən(t)s	тишина
calculate	'kælkjʊleɪt	вычислять,  предназначать (для чего-л.)
arise	ə'raɪz	возникать,  появляться
cheat	ʧi:t	мошенничать
late	leɪt	поздний,  запоздалый
disappear	,dɪsə'pɪə	исчезать (из поля зрения)
select	sɪ'lekt	выбирать
escape	ɪs'keɪp	совершать побег
anyway	enɪweɪ	в любом случае
type	taɪp	тип,  род,  писать,  печатать на машинке
peculiar	pɪ'kju:lɪə	специфический,  особенный,  личная собственность
hail	heɪl	град,  приветствовать
correct	kə'rekt	правильный,  исправлять
carve	kɑ:v	вырезать (по дереву),  гравировать
smell	smel	обоняние,  запах
employ	ɪm'plɒɪ	держать на службе,  предоставлять работу
devote	dɪ'vəʊt	посвящать (себя чему-то возвышенному)
tree	tri:	дерево
essence	'es(ə)n(t)s	сущность,  эссенция
dread	dred	ужас
aim	eɪm	намерение,  цель
queen	kwi:n	королева
displace	dɪs'pleɪs	перемещать
consequence	'kɒn(t)sɪkwən(t)s	(по)следствие,  результат (чего-л.)
dissent	dɪ'sent	несходство взглядов
health	helθ	здоровье
mischief	'mɪsʧɪf	вред,  ущерб
boy	bɒɪ	мальчик
obey	ə'beɪ	подчиняться,  слушаться
declare	dɪ'kleə	заявлять,  объявлять
anxious	æŋ(k)ʃəs	озабоченный,  беспокоящийся
loan	ləʊn	заём,  ссуда
colloquial	kə'ləʊkwɪəl	разговорный
cello	'ʧeləʊ	виолончель
yawn	jɔ:n	зевать
cool	ku:l	прохлада
imprison	ɪm'prɪz(ə)n	заключать в тюрьму
thief	θi:f	вор,  нагар
decade	'dekeɪd	группа из десяти,  десяток
fleet	fli:t	военно-морской флот,  быстрый
chat	ʧæt	беседовать
influence	'ɪnflʊən(t)s	влияние,  индукция
sad	sæd	грустный,  печальный
efficiency	ɪ'fɪʃ(ə)n(t)sɪ	эффективность,  результативность
dense	den(t)s	плотный,  сжатый,  густой
disperse	dɪ'spɜ:s	рассеивать,  разгонять
three	θri:	три
zip	zɪp	застёжка-молния,  почтовый индекс
precise	prɪ'saɪs	точный,  отчётливый
crooked	'krʊkɪd	изогнутый,  кривой
maize	meɪz	кукуруза,  маис
curious	'kjʊərɪəs	любопытный
civil	'sɪv(ə)l	гражданский (в отличие от военного),  цивилизованный
starch	stɑ:ʧ	крахмал
surround	sə'raʊnd	окружать
degrade	dɪ'greɪd	ухудшать
quay	ki:	причал
whistle	'(h)wɪsl	свистеть
cinema	sɪnəmə	кинофильм,  кинотеатр
devise	dɪ'vaɪz	продумывать (планы),  изобретать,  завещать
accidentally	,æksɪ'dent(ə)lɪ	случайно,  нечаянно
inside	,ɪn'saɪd	внутренняя часть,  внутренность
nickname	'nɪkneɪm	прозвище,  кличка
peak	pi:k	высшая точка,  слабеть
candid	'kændɪd	откровенный,  справедливый
reason	'ri:z(ə)n	причина,  разум,  рассуждать
age	eɪʤ	возраст,  совершеннолетие
wonder	'wʌndə	удивление,  изумление
mayor	meə	мэр
calf	kɑ:f	телёнок,  икра (ноги)
improve	ɪm'pru:v	улучшать
overnight	,əʊvə'naɪt	происходивший накануне вечером,  ночной
rid	rɪd	(of) освобождать,  избавлять (от чего-л. / кого-л.)
smoke	sməʊk	дым
chose	ʃəʊz	движимое имущество,  выбирал
faculty	'fæk(ə)ltɪ	дар,  способность
disadvantage	,dɪsəd'vɑ:ntɪʤ	неудобство,  невыгодное положение
sister	'sɪstə	сестра
curtain	'kɜ:t(ə)n	занавеска,  штора
cell	sel	секция,  отсек,  клетка (биол.)
blend	blend	смешивать
speed	spi:d	скорость
gangway	'gæŋweɪ	проход (в театре),  сходни
lunch	lʌnʧ	обед (в середине рабочего дня)
sale	seɪl	продажа
this	ðɪs	этот
access	ækses	доступ
arithmetic	ə'rɪθmətɪk	арифметика,  счёт
perceive	pə'si:v	понимать,  осознавать
after	ɑ:ftə	за (вслед за кем-л. / чем-л.),  после,  через
guitar	gɪ'tɑ:	гитара
recommend	,rekə'mend	рекомендовать,  советовать
topic	'tɒpɪk	тема,  предмет обсуждения
net	net	сеть,  западня
heart	hɑ:t	сердце (орган тела)
leather	'leðə	кожа (выделанная)
foam	fəʊm	пена,  пузырьки
thing	θɪŋ	вещь,  предмет
defence	dɪ'fen(t)s	защита,  оборона
jest	ʤest	шутка
window	'wɪndəʊ	окно
nominate	'nɒmɪneɪt	предлагать кандидата,  номинировать (на награду)
worthy	'wɜ:ðɪ	достойный,  подходящий
besides	bɪ'saɪdz	кроме того,  за исключением
guard	gɑ:d	охрана,  защита,  часовой
chestnut	'ʧesnʌt	каштан (плод),  каштанового цвета
handicraft	'hændɪkrɑ:ft	ремесло,  ручная работа
vein	veɪn	вена
awkward	ɔ:kwəd	неуклюжий,  неудобный
ease	i:z	облегчать,  успокаивать
modest	'mɒdɪst	скромный,  сдержанный
career	kə'rɪə	карьера,  успех
garbage	'gɑ:bɪʤ	мусор
reed	ri:d	тростник,  камыш
hood	hʊd	капюшон
illegal	ɪ'li:g(ə)l	незаконный,  нелегальный
proceed	prə'si:d	продолжать (говорить),  направляться,  идти
regret	rɪ'gret	сожаление,  раскаяние
large	lɑ:ʤ	большой,  крупный
and	ænd	и,  а,  но
pie	paɪ	пирог
bone	bəʊn	кость,  захватывать в собственность
arid	ærɪd	сухой,  засушливый,  скучный
ink	ɪŋk	чернила,  писать чернилами
oven	'ʌv(ə)n	печь,  духовка
slim	slɪm	тонкий,  худой
liquid	'lɪkwɪd	жидкость
snake	sneɪk	змея
marble	'mɑ:bl	мрамор
latitude	'lætɪtju:d	широта (геогр),  самостоятельность
fall	fɔ:l	падать (с высоты)
jump	ʤʌmp	прыгать
prompt	prɒmpt	проворный,  быстрый,  побуждать,  подсказка
opportunity	,ɒpə'tju:nətɪ	удобный случай,  стечение обстоятельств
solitary	'sɒlɪt(ə)rɪ	одинокий,  единичный
concession	kən'seʃ(ə)n	уступка,  признание (какого-л. факта)
carry	kærɪ	нести,  переносить
amuse	ə'mju:z	развлекать
barman	bɑ:mən	бармен
conscience	'kɒn(t)ʃ(ə)n(t)s	совесть
pedestrian	pɪ'destrɪən	пешеход
warrant	'wɒr(ə)nt	ордер (на арест),  гарантировать
property	'prɒpətɪ	имущество,  собственность
bankrupt	bæŋkrʌpt	банкрот,  неплатежеспособный,  сломанный
plain	pleɪn	очевидный,  простой,  равнина
family	'fæm(ə)lɪ	семья
cancel	'kæn(t)s(ə)l	вычёркивать,   стирать,  отменять
sky	skaɪ	небо
roof	ru:f	крыша
witness	'wɪtnəs	свидетель,  очевидец
prevail	prɪ'veɪl	преобладать,  достичь цели
statute	'stætu:t	закон,  устав
kidnap	'kɪdnæp	похищать людей (с целью получить выкуп)
brother	brʌðə	брат
whenever	(h)wen'evə	(ну) когда же,  всякий раз когда
blouse	blaʊz	блузка,  кофточка,  рабочая блуза
regular	'regjələ	правильный,  регулярный
remind	rɪ'maɪnd	напоминать
water	'wɔ:tə	вода
olive	'ɒlɪv	маслина,  оливка (плод)
outfit	'aʊtfɪt	снаряжение (для экспедиции, путешествия)
violet	'vaɪələt	фиалка,  фиолетовый цвет
vicinity	vɪ'sɪnətɪ	близость,  соседство,  окрестности
circuit	'sɜ:kɪt	круг,  объезд,  цикл
brass	brɑ:s	латунь,  жёлтая медь
advisory	əd'vaɪz(ə)rɪ	рекомендательный,  совещательный
travel	'træv(ə)l	путешествовать
physician	fɪ'zɪʃ(ə)n	врач,  терапевт
approach	ə'prəʊʧ	подходить, приближаться,  обращаться (с просьбой)
begin	bɪ'gɪn	начинать
missile	'mɪsaɪl	реактивный снаряд,  ракета
fallow	'fæləʊ	невспаханный,  земля под паром
recent	'ri:s(ə)nt	недавний,  современный
bicycle	baɪsɪkl	велосипед
fracture	'frækʧə	перелом,  трещина
onion	'ʌnjən	репчатый лук,  луковица
provoke	prə'vəʊk	вызывать,  провоцировать,  сердить
universe	'ju:nɪvɜ:s	мироздание,  вселенная
structure	'strʌkʧə	строение,  структура
angle	æŋgl	угол,  точка зрения,  рыболовный крючок
note	nəʊt	заметка,  запись
engine	'enʤɪn	машина,  двигатель
twice	twaɪs	дважды,  во второй раз
nucleus	'nju:klɪəs	ядро,  центр
endurance	ɪn'djʊər(ə)n(t)s	выносливость,  стойкость
tin	tɪn	олово,  лудить,  консервировать (в жестяных банках)
chocolate	'ʧɒklət	шоколад
curse	kɜ:s	проклятие,  ругательство
neighbourhood	'neɪbəhʊd	близость,  соседство,  окрестности
dismiss	dɪs'mɪs	отпускать,  увольнять
hurricane	'hʌrɪkeɪn	ураган
menace	'menɪs	угроза,  опасность
appoint	ə'pɒɪnt	назначать,  определять (время, место)
echo	'ekəʊ	эхо,  отражаться
pamphlet	'pæmflɪt	брошюра,  инструкция,  злая сатира
than	ðæn	чем
outrageous	,aʊt'reɪʤəs	возмутительный
stand	stænd	стоять,  подставка,  этажерка
intelligence	ɪn'telɪʤ(ə)n(t)s	интеллект,  рассудок,  разум
repair	rɪ'peə	ремонтировать,  направляться (куда-л.)
are	ɑ:	ар (мера земельной площади = 100 кв. м), быть 2л. мн.ч
axis	æksɪs	ось,  осевая линия
towards	tə'wɔ:dz	к,  по направлению к
yard	jɑ:d	двор,  ярд (мера длины 3 фута или 91,4 см)
chew	ʧu:	жевать,  грызть
something	'sʌmθɪŋ	кое-что,  что-нибудь
plum	plʌm	слива,  изюм,  пышный,  мягкий (о подушке)
kindly	'kaɪndlɪ	приятный,  дружелюбный
fail	feɪl	иметь недостаток в чём-л.
stone	stəʊn	камень
ultimate	'ʌltɪmət	последний,  максимальный
majority	mə'ʤɒrətɪ	большинство,  совершеннолетие
output	'aʊtpʊt	продукция,  выпуск изделий
bay	beɪ	бухта, пролёт моста,  ж.д. платформа,  лай,  гнедой
neglect	nɪ'glekt	пренебрежение,  игнорирование
another	ə'nʌðə	другой,  ещё один
culture	'kʌlʧə	культура
automatic	,ɔ:tə'mætɪk	автоматический,  автоматизированный
jet	ʤet	чёрный янтарь,  сильная струя,  реактивный двигатель
cover	'kʌvə	крышка,  обложка,  убежище
consider	kən'sɪdə	рассматривать,  обсуждать
journey	'ʤɜ:nɪ	путешествие
music	'mju:zɪk	музыка
mask	mɑ:sk	маска
range	reɪnʤ	ряд,  линия,  дистанция,  скитаться
wear	weə	носить
hide	haɪd	прятаться,  шкура
shave	ʃeɪv	брить,  коротко стричь
forest	'fɒrɪst	лес
back	bæk	спина,  назад,  корыто
fat	fæt	толстый,  жирный
seat	si:t	сиденье,  усаживать
devastate	'devəsteɪt	истощать,  опустошать
aloud	ə'laʊd	вслух,  громко
inferior	ɪn'fɪərɪə	подчинённый,  младший по чину
delight	dɪ'laɪt	удовольствие,  наслаждение
joy	ʤɒɪ	радость
foil	fɒɪl	фольга,  фон,  рапира
major	'meɪʤə	майор,  более важный,  совершеннолетний
deport	dɪ'pɔ:t	высылать,  выдворять,  вести себя
gain	geɪn	добывать,  извлекать пользу,  вырез,  паз
continent	'kɒntɪnənt	материк,  сдержанный,  целомудренный
oxygen	'ɒksɪʤən	кислород
lily	'lɪlɪ	лилия
every	'evrɪ	каждый
open	'əʊp(ə)n	открывать
sphere	sfɪə	сфера,  шар
advertise	ædvətaɪz	рекламировать
perennial	p(ə)'renɪəl	вечный,  многолетний
plus	plʌs	плюс,  преимущество
ancient	eɪn(t)ʃ(ə)nt	древний,  старинный
teach	ti:ʧ	учить,  обучать
account	ə'kaʊnt	счёт,  отчёт,  мнение
passer-by	,pɑ:sə'baɪ	прохожий
sole	səʊl	единственный,  подошва,  морской язык (рыба)
broke	brəʊk	безденежный,  бедный,  прош. вр. break - ломать
short	ʃɔ:t	короткий
well-being	'wel,bi:ɪŋ	здоровье,  (материальное) благосостояние
immediate	ɪ'mi:dɪət	прямой,  непосредственный,  безотлагательный
morning	'mɔ:nɪŋ	утро
eve	i:v	канун,  преддверие
abuse	ə'bju:s	оскорблять,  злоупотреблять
altitude	æltɪtju:d	высота,  высота над уровнем моря
cement	sə'ment	цемент
premium	'pri:mɪəm	награда,  приз,  высший сорт
endeavour	ɪn'devə	попытка,  старание
busy	bɪzɪ	деятельный,  занятой,  сыщик
reveal	rɪ'vi:l	обнаруживать,  разоблачать
odd	ɒd	нечётный,  непарный,  необычный
admiralty	ædm(ə)rəltɪ	(the Admiralty) адмиралтейство,  морское министерство (в Англии)
touch	tʌʧ	касаться,  трогать
majesty	'mæʤəstɪ	величественность
slip	slɪp	скользить,  побег,  росток,  свернувшееся молоко
strength	streŋθ	сила
wink	wɪŋk	подмигивать,  смотреть сквозь пальцы на (что-л.)
ash	æʃ	зола,  пепел,  руины, ясень
fitter	'fɪtə	сборщик,  слесарь-монтажник
bouquet	bʊ'keɪ	букет,  комплимент
fox	fɒks	лиса,  обманывать
monastery	'mɒnəst(ə)rɪ	(мужской) монастырь
polite	pə'laɪt	вежливый
entrance	'entrən(t)s	вход,  входная дверь
involve	ɪn'vɒlv	привлекать,  вовлекать
trick	trɪk	обман,  трюк
autonomous	ɔ:'tɒnəməs	независимый,  автономный
cross	krɒs	крест,  распятие
enumerate	ɪ'nju:m(ə)reɪt	перечислять,  пересчитывать
missing	'mɪsɪŋ	отсутствующий
crawl	krɔ:l	ползать
bunch	bʌnʧ	пучок,  пачка,  букет (цветов)
think	θɪŋk	думать,  понимать
intervention	,ɪntə'venʃ(ə)n	вмешательство
raw	rɔ:	сырой (о пище),  недоработанный,  сдирать кожу
exclaim	ɪks'kleɪm	восклицать
dirt	dɜ:t	грязь
flag	flæg	флаг,  дёрн,  поникнуть
haul	hɔ:l	тащить
inch	ɪnʧ	дюйм (единица длины = 1/12 фута  = 2,54 см)
construct	kən'strʌkt	строить,  сооружать
blade	bleɪd	лезвие,  клинок,  лопасть (винта)
survive	sə'vaɪv	пережить (по времени)
cheek	ʧi:k	щека,  наглость
birth	bɜ:θ	рождение,  появление на свет
prevent	prɪ'vent	предотвращать,  предупреждать
ask	ɑ:sk	спрашивать,  приглашать
jewel	'ʤu:əl	драгоценный камень
remain	rɪ'meɪn	оставаться
before	bɪ'fɔ:	впереди,  прежде,  раньше
cutlery	'kʌtl(ə)rɪ	ножевые изделия
trophy	'trəʊfɪ	трофей,  добыча
diary	'daɪərɪ	дневник,  ежедневник
scream	skri:m	пронзительно кричать
bank	bæŋk	банк,  насыпь,  скамья (в лодке)
sneeze	sni:z	чихать
lamb	læm	ягнёнок,  простак
female	'fi:meɪl	женщина,  самка
juvenile	'ʤu:v(ə)naɪl	молодой,  юный
legitimate	lɪ'ʤɪtəmət	законнорождённый,  рождённый в браке
comb	kəʊm	расчёска
orchestra	'ɔ:kɪstrə	оркестр
disease	dɪ'zi:z	болезнь
shift	ʃɪft	перемещать,  изменять
mild	maɪld	мягкий,  спокойный
respond	rɪ'spɒnd	отвечать
illuminate	ɪ'lu:mɪneɪt, ɪ'lju:mɪneɪt	освещать
race	reɪs	состязание в беге,  раса
plough	plaʊ	плуг,  снегоочиститель
area	eərɪə	площадь,  участок,  пространство
secondary	'sek(ə)nd(ə)rɪ	второй (по порядку),  вспомогательный
broth	brɒθ	отвар,  бульон
imply	ɪm'plaɪ	предполагать,  подразумевать
grievance	'gri:v(ə)n(t)s	обида,  жалоба
dumb	dʌm	немой,  молчаливый
by	baɪ	у,  при,  около
rush	rʌʃ	тростник,  камыш,  стремительное движение
scare	skeə	пугать
scale	skeɪl	чешуя,  чаша весов,  масштаб,  градация
while	(h)waɪl	пока,  в то время как,  промежуток времени
apartment	ə'pɑ:tmənt	комната
limb	lɪm	конечность (человека или животного),  ветка
entrust	ɪn'trʌst	поручать (кому-л.)
norm	nɔ:m	норма,  стандарт
nasty	'nɑ:stɪ	отвратительный,  грязный
cold	kəʊld	холодный,  беспристрастный
holiday	'hɒlədeɪ	праздник,  каникулы
undergo	,ʌndə'gəʊ	испытывать,  подвергаться (чему-л.)
niece	ni:s	племянница
insert	ɪn'sɜ:t	вклейка (в книге),  вставлять,  вкладывать
voltage	'vəʊltɪʤ	электрическое напряжение
order	'ɔ:də	порядок,  исправность,  приказ
hint	hɪnt	намёк
wardrobe	'wɔ:drəʊb	гардероб,  шкаф
weary	'wɪərɪ	усталый,  утомлённый
shed	ʃed	проливать,  ронять,  навес,  сарай
grocer	'grəʊsə	торговец бакалейными товарами,  бакалейщик
bullet	bʊlɪt	пуля,  грузило
apron	eɪpr(ə)n	передник,  фартук
relieve	rɪ'li:v	помогать,  облегчать
possible	'pɒsəbl	вероятный,  возможный
shut	ʃʌt	закрывать
playmate	'pleɪmeɪt	друг детства,  товарищ по детским играм
spill	spɪl	проливать,  рассыпать,  лучина,  щепка
private	'praɪvɪt	частный,  личный,  секретный
crimson	'krɪmz(ə)n	малиновый
saw	sɔ:	пила
proper	'prɒpə	присущий,  правильный
vocabulary	və'kæbjʊl(ə)rɪ	словарь
interval	'ɪntəv(ə)l	промежуток,  расстояние
barn	bɑ:n	амбар,  сарай,  конюшня
capacity	kə'pæsətɪ	вместимость,  способность (что-л. делать)
but	bʌt	но,  а,  лишь,  только
rung	rʌŋ	ступенька (лестницы),  перекладина,  звенел
example	ɪg'zɑ:mpl	пример
gap	gæp	брешь,  щель
rate	reɪt	норма,  цена,  ругать
anxiety	æŋ(g)'zaɪətɪ	беспокойство,  тревога,  боязнь
stain	steɪn	пятно,  позор
cobweb	'kɒbweb	паутина,  прозрачная ткань
such	sʌʧ	такой
poor	pɔ:, pʊə	бедный
harness	'hɑ:nɪs, 'hɑ:nəs	упряжь,  сбруя
chest	ʧest	ящик,  коробка,  грудная клетка
smelt	smelt	расплавленный металл
drip	drɪp	капать
contradict	,kɒntrə'dɪkt	противоречить,  возражать
multiplication	,mʌltɪplɪ'keɪʃ(ə)n	умножение
liberate	'lɪb(ə)reɪt	освобождать
athlete	æθli:t	спортсмен,  легкоатлет
outskirts	'aʊtskɜ:ts	окраина (города),  опушка (леса)
gypsy	'ʤɪpsɪ	цыган
nephew	'nefju:, 'nevju:	племянник
degree	dɪ'gri:	степень,  уровень
meat	mi:t	мясо
peace	pi:s	мир,  спокойствие
unite	ju:'naɪt	объединять
mistake	mɪ'steɪk	ошибка
wave	weɪv	волна,  развеваться (о флагах)
carnation	kɑ:'neɪʃ(ə)n	гвоздика
faith	feɪθ	вера,  доверие
field	fi:ld	поле,  широкое пространство
tomato	tə'mɑ:təʊ	помидор,  томат
fear	fɪə	боязнь,  страх
selfish	'selfɪʃ	эгоистичный
source	sɔ:s	источник
feel	fi:l	чувствовать,  ощупывать
worst	wɜ:st	наихудший
design	dɪ'zaɪn	замысел,  план
cheese	ʧi:z	сыр,  нечто важное,  прекращать
right	raɪt	правый,  правильный
asylum	ə'saɪləm	убежище,  защита,  приют
moon	mu:n	луна
address	ə'dres	адрес,  место жительства
alter	ɔ:ltə	изменять
jeer	ʤɪə	насмехаться
woman	'wʊmən	женщина
clock	klɒk	часы (настенные, настольные, башенные)
astonishment	ə'stɒnɪʃmənt	изумление,  удивление
fuel	fju:əl	топливо,  горючее
lord	lɔ:d	господин
foresight	'fɔ:saɪt	предвидение,  благоразумие
appearance	ə'pɪər(ə)n(t)s	появление,  внешний вид
legislation	,leʤɪ'sleɪʃ(ə)n	законодательство
principle	'prɪn(t)səpl	правило,  закон,  принцип
embark	ɪm'bɑ:k	грузиться,  садиться на корабль
avenue	ævənju:	аллея к дому, обсаженная деревьями,  широкая улица
fly	flaɪ	муха,  летать
code	kəʊd	свод законов (государства),  шифр
annex	æneks	приложение,  дополнение (к тексту)
saucer	'sɔ:sə	блюдце
pier	pɪə	дамба,  причал
storm	stɔ:m	буря
alphabet	ælfəbət	алфавит,  азбука
satellite	'sæt(ə)laɪt	спутник
acknowledge	ək'nɒlɪʤ	сознавать,  допускать,  признавать
abstract	æbstrækt	абстракция,  отвлечённое понятие,  малопонятный
club	klʌb	дубинка,  клюшка,  клуб,  трефовая масть
relative	'relətɪv	родственник,  относительный,  сравнительный
rot	rɒt	гниение,  полоса неудач
receive	rɪ'si:v	получить,  принимать (гостей)
flax	flæks	лён
furniture	'fɜ:nɪʧə	мебель,  обстановка,  принадлежности
vanish	'vænɪʃ	исчезать
atmosphere	ætməsfɪə	атмосфера,  обстановка
brave	breɪv	отважный,  индейский воин
arrow	ærəʊ	стрела
wish	wɪʃ	желать,  хотеть
support	sə'pɔ:t	поддержка,  помощь
cherry	ʧerɪ	вишня
behaviour	bɪ'heɪvjə	образ действий,  поведение
tidy	'taɪdɪ	аккуратный,  салфетка
trail	treɪl	след (человека или животного),  тропинка
arrange	ə'reɪnʤ	приводить в порядок,  расставлять
initial	ɪ'nɪʃ(ə)l	начальный,  исходный
undeniable	,ʌndɪ'naɪəbl	неоспоримый,  неопровержимый
bold	bəʊld	смелый,  храбрый,  наглый
acre	eɪkə	акр (единица площади = 0,4 га = 4047 кв.м)
pebble	'pebl	галька,  горный хрусталь
jacket	'ʤækɪt	куртка
gloom	glu:m	мрак,  темнота
quote	kwəʊt	цитировать,  назначать цену
there	ðeə	там,  туда
atrocity	ə'trɒsətɪ	жестокость,  злодеяние
mad	mæd	сумасшедший,  ненормальный
style	staɪl	стиль,  манера
naughty	'nɔ:tɪ	непослушный
clumsy	'klʌmzɪ	неповоротливый,  неуклюжий
yacht	jɒt	яхта
crop	krɒp	урожай,  жатва,  посев
swim	swɪm	плавать
botanical	bə'tænɪk(ə)l	ботанический
complicate	'kɒmplɪkeɪt	затруднять,  усложнять
cook	kʊk	повар,  готовить
hike	haɪk	длительная прогулка,  путешествие пешком
coffin	'kɒfɪn	гроб
ready	'redɪ	готовый (к действию)
pincers	'pɪn(t)səz	щипцы,  пинцет
glitter	'glɪtə	блестеть,  сверкать
jolly	'ʤɒlɪ	весёлый,  радостный
cannon	'kænən	пушка,  револьвер,  столкнуться
safe	seɪf	безопасный,  надёжный,  сейф
tale	teɪl	рассказ,  сказка
wise	waɪz	мудрый,  метод,  способ
furnace	'fɜ:nɪs	очаг
affirmative	ə'fɜ:mətɪv	положительный,  утвердительный,  заявление
botany	bɒtənɪ	ботаника
chair	ʧeə	стул,  должность
suitable	'su:təbl, 'sju:təbl	годный,  подходящий
nowhere	'nəʊweə	нигде,  никуда
girdle	'gɜ:dl	пояс,  ремень
truth	tru:θ	правда,  истина
state	steɪt	состояние,  положение,  государство,  штат
disgust	dɪs'gʌst	отвращение
beg	beg	просить,  умолять
excite	ɪk'saɪt	побуждать,  стимулировать
pond	pɒnd	пруд
port	pɔ:t	гавань,  осанка,  левый борт (корабля),  портвейн
estate	ɪs'teɪt	поместье,  имущество
obligation	,ɒblɪ'geɪʃ(ə)n	гарантия,  обязательство
consumer	kən'sju:mə	потребитель
coffer	'kɒfə	сундук,  казна
festival	'festɪv(ə)l	празднество
opinion	ə'pɪnjən	мнение,  оценка
variety	və'raɪətɪ	разнообразие,  варьете
attache	ə'tæʃeɪ	атташе посольства
entry	'entrɪ	вход,  въезд,  проход
commerce	'kɒmɜ:s, kəmɜ:s	(оптовая) торговля,  коммерция,  общение
patent	'peɪt(ə)nt	открытый,  доступный,  патент
lost	lɒst	потерянный
barely	beəlɪ	просто,  всего лишь,  еле-еле
break	breɪk	ломать,  разбивать (на части)
cost	kɒst	цена,  затраты
tobacco	tə'bækəʊ	табак
absolutely	,æbs(ə)'lu:tlɪ	совершенно,  безусловно
often	'ɒf(ə)n, 'ɒft(ə)n	часто
single	'sɪŋgl	один,  единственный
interfere	,ɪntə'fɪə	пересекаться,  скрещиваться (в пространстве)
casualty	'kæʒʊəltɪ	катастрофа,  авария
secret	'si:krət	секрет,  тайна
invaluable	ɪn'væljʊəbl	бесценный
paid	peɪd	платный
muscle	'mʌsl	мышца
amendment	ə'men(d)mənt	поправка (к резолюции, законопроекту)
blunder	blʌndə	грубая ошибка,  просчёт
brunette	bru:'net	брюнетка
substitute	'sʌbstɪtju:t	заместитель,  заменять
pave	peɪv	мостить,  выстилать (пол)
doubt	daʊt	сомневаться
cling	klɪŋ	цепляться,  крепко держаться
parliament	'pɑ:ləmənt	парламент,  имбирный пряник
assault	ə'sɔ:lt	атаковать,  штурмовать
fuse	fju:z	процесс плавления,  предохранитель,  взрыватель
stomach	'stʌmək	желудок,  терпеть
income	'ɪŋkʌm, 'ɪnkʌm	доход,  прибыль
hammer	'hæmə	молоток
adhesive	əd'hi:sɪv	липкий,  клейкий,  связывающий
actually	'ækʧʊəlɪ	на самом деле,  в действительности
case	keɪs	случай,  коробка,  защищать,  покрывать
boring	bɔ:rɪŋ	бурение,  сверление
agitate	æʤɪteɪt	агитировать,  волновать,  взбалтывать
scratch	skræʧ	царапать,  скрести
frying-pan	'fraɪɪŋpæn	сковорода с ручкой
target	'tɑ:gɪt	цель,  мишень
wrap	ræp	завёртывать,  оболочка
bike	baɪk	велосипед,  мотоцикл
servant	'sɜ:v(ə)nt	слуга
cushion	'kʊʃ(ə)n	диванная подушка
ship	ʃɪp	корабль
suppose	sə'pəʊz	думать,  предполагать
blast	blɑ:st	порыв ветра,  взрыв,  ударная волна,  курение трубки
clasp	klɑ:sp	прикреплять,  застёгивать
brand	brænd	торговая марка,  бренд,  выжигать клеймо
direction	dɪ'rekʃ(ə)n	направление
district	'dɪstrɪkt	район,  округ
cloak-room	'kləʊkrʊm	гардероб,  вешалка
envelope	'envələʊp	конверт
complex	'kɒmpleks	совокупность,  комплекс,  группа
soil	sɒɪl	грунт,  почва,  пачкать,  давать скоту зелёный корм
reach	ri:ʧ	дотягиваться (до чего-л.),  доезжать
relation	rɪ'leɪʃ(ə)n	отношение,  зависимость,  родственник
white	(h)waɪt	белый
link	lɪŋk	звено (цепи),  связь,  факел
according	ə'kɔ:dɪŋ	согласный,  гармоничный
become	bɪ'kʌm	становиться,  делаться
pace	peɪs	шаг,  длина шага,  скорость
department	dɪ'pɑ:tmənt	отдел,  цех
barrier	bærɪə	перегородка,  барьер
know	nəʊ	знать,  уметь
attendance	ə'tendən(t)s	присутствие,  посещение,  зрители
fix	fɪks	прикреплять
abduct	əb'dʌkt	похищать,  насильно уводить
cart	kɑ:t	телега
clap	klæp	хлопать,  аплодировать
favour	'feɪvə	благосклонность,  покровительство
pair	peə	пара,  двое
theme	θi:m	тема,  основная мысль
bulk	bʌlk	груда,  основная масса,  прилавок,  ларек
best	best	от good лучший,  наилучший
vessel	'ves(ə)l	сосуд (для жидкости),  корабль
excess	ɪk'ses	чрезмерность,  неумеренность
pearl	pɜ:l	жемчуг,  перламутр,  капелька росы
top	tɒp	верхушка,  вершина,  юла
paperback	'peɪpəbæk	в мягком переплёте
denounce	dɪ'naʊn(t)s	обвинять
sour	'saʊə	кислый
apparently	ə'pær(ə)ntlɪ	очевидно,  несомненно,  вероятно
tired	'taɪəd	усталый,  увядший (о растениях)
sail	seɪl	парус,  плавание
series	'sɪəri:z	ряд,  последовательность
ill	ɪl	больной,  вред
altogether	,ɔ:ltə'geðə	всецело,  целое
distinguish	dɪ'stɪŋgwɪʃ	различать,  разглядеть,  рассмотреть
mist	mɪst	лёгкий туман,  дымка
canteen	kæn'ti:n	буфет,  столовая,  солдатская фляга (3-4 пинты)
belt	belt	пояс,  корсет
oar	ɔ:	весло
ascent	ə'sent	восхождение,  подъём
blond	blɒnd	блондин,  светлый (о волосах)
quantity	'kwɒntətɪ	количество
assert	ə'sɜ:t	утверждать,  заявлять
planet	'plænɪt	планета
look	lʊk	взгляд,  смотреть
expert	'ekspɜ:t	знаток,  опытный
analyse	æn(ə)laɪz	анализировать,  исследовать,  разлагать (хим)
bird	bɜ:d	птица
previous	'pri:vɪəs	предыдущий,  предшествующий
main	meɪn	главная часть,  основное
energy	'enəʤɪ	энергия,  сила
nut	nʌt	орех,  гайка
magazine	,mægə'zi:n	склад боеприпасов,  периодический журнал
ideal	aɪ'dɪəl	идеал,  образец совершенства
coarse	kɔ:s	грубый,  крупнозернистый,  шероховатый
situation	,sɪʧʊ'eɪʃ(ə)n	обстановка,  положение,  ситуация
sure	ʃɔ:, ʃʊə	уверенный
alarm-clock	ə'lɑ:mklɒk	будильник
land	lænd	земля,  суша
car	kɑ:	автомобиль,  вагон трамвая
peg	peg	колышек,  затычка (бочки)
milk	mɪlk	молоко,  доить
kid	kɪd	козлёнок,  малыш,  подшучивать
goal	gəʊl	цель
evidence	'evɪd(ə)n(t)s	ясность,  очевидность
gravy	'greɪvɪ	подливка,  соус,  лёгкая нажива
future	'fju:ʧə	будущее
damp	dæmp	влажный,  сырой,  подавленное состояние
heritage	'herɪtɪʤ	наследство
spy	spaɪ	шпион
lounge	laʊnʤ	гостиная,  сидеть развалившись
then	ðen	затем,  тогда
flea	fli:	блоха
conclude	kən'klu:d	завершать,  подвести итог
appreciate	ə'pri:ʃɪeɪt	оценивать,  понимать
shudder	'ʃʌdə	вздрагивать,  содрогаться
curtail	kɜ:'teɪl	сокращать,  укорачивать
fortune	'fɔ:ʧu:n	фортуна,  удача
channel	'ʧæn(ə)l	канал,  пролив
care	keə	забота
temptation	tem(p)'teɪʃ(ə)n	искушение,  соблазн
poultry	'pəʊltrɪ	домашняя птица
expel	ɪk'spel	исключать (из какой-л. организации),  выгонять
issue	'ɪʃu:	выпуск (продукции),  издание (печатной продукции)
data	'deɪtə	данные,  факты,  сведения
agreeable	ə'grɪəbl	приятный,  выражающий согласие
nail	neɪl	ноготь,  гвоздь
fury	'fjʊərɪ	бешенство,  ярость,  фурия,  сварливая женщина
sob	sɒb	рыдать,  всхлипывать
understand	,ʌndə'stænd	понимать
price	praɪs	цена
weight	weɪt	вес,  масса
walnut	'wɔ:lnʌt	грецкий орех
children	ʧɪldr(ə)n	дети
insane	ɪn'seɪn	душевнобольной,  сумасшедший
cigarette	,sɪg(ə)'ret	сигарета
tart	tɑ:t	кислый,  едкий,  фруктовое пирожное
dull	dʌl	тупой,  незаточенный,  глупый
little	'lɪtl	маленький
without	wɪ'ðaʊt	без,  в отсутствие
ass	æs	осёл,  задница
student	'stju:d(ə)nt	студент
part	pɑ:t	доля,  часть,  расставаться
forward	'fɔ:wəd	передний,  прогрессивный
gear	gɪə	механизм,  устройство,  шестерня
guilt	gɪlt	вина
less	les	меньший,  без, исключая (что-либо)
bright	braɪt	яркий,  блестящий
cab	kæb	такси,  кабина водителя,  шпаргалка
wool	wʊl	шерсть
gasoline	'gæs(ə)li:n	газолин,  бензин
father	'fɑ:ðə	отец
lazy	'leɪzɪ	ленивый
cock	kɒk	петух,  носик (чайника),  курок,  стрелка весов
pastry	'peɪstrɪ	выпечка,  тесто
Easter	'i:stə	Пасха (праздник)
schedule	'ʃedju:l	список,  каталог
tongue	tʌŋ	язык
both	bəʊθ	оба
adventure	əd'venʧə	приключение,  рисковать
assist	ə'sɪst	помогать, принимать участие
table	'teɪbl	стол,  класть (что-л.) на стол
abrupt	ə'brʌpt	внезапный,  неожиданный,  крутой,  обрывистый
handsome	'hæn(d)səm	красивый,  статный (о мужчине)
accomplish	ə'kɒmplɪʃ	совершать,  выполнять,  завершать
key	ki:	ключ,  шпонка,  риф
item	'aɪtəm	пункт,  параграф
shock	ʃɒk	удар,  копна
ape	eɪp	человекообразная обезьяна (Pongidae)
separate	'sep(ə)reɪt	отделять,  разделять
map	mæp	карта (географическая)
damn	dæm	проклятие,  ругательство
rash	ræʃ	поспешный,  сыпь,  шелест
fever	'fi:və	жар,  лихорадка
loyal	'lɒɪəl	верный,  преданный
fleece	fli:s	руно,  овечья шерсть
curve	kɜ:v	кривая (диаграмма,  )хитрость
few	fju:	мало,  немного
disappoint	,dɪsə'pɒɪnt	разочаровывать
host	həʊst	куча,  толпа,  хозяин,  хлеб в таинстве причащения
mutton	'mʌt(ə)n	баранина
dig	dɪg	копать,  рыть
ranch	rɑ:nʧ	ранчо,  крупное фермерское хозяйство
policy	'pɒləsɪ	политика,  линия поведения,  страховой полис
circus	'sɜ:kəs	цирк,  круглая площадь с расходящимися улицами
twin	twɪn	близнец,  двойной
claw	klɔ:	коготь,  царапать
freeze	fri:z	замерзать,  замораживать
school	sku:l	школа,  класс
partial	'pɑ:ʃ(ə)l	частичный,  неполный
deprive	dɪ'praɪv	отбирать,  отнимать
behind	bɪ'haɪnd	позади,  позже
vengeance	'venʤ(ə)n(t)s	месть
drunk	drʌŋk	напившийся,  пьяный
beer	bɪə	пиво
deck	dek	палуба,  взгляд
fright	fraɪt	испуг
sincere	sɪn'sɪə	искренний,  настоящий
lid	lɪd	крышка,  веко
lemon	'lemən	лимон
bend	bend	сгибать
earth	ɜ:θ	земля,  суша
itself	ɪt'self	себя,  себе
herself	hɜ:'self	себя,  себе
soft	sɒft	мягкий
immense	ɪ'men(t)s	очень большой,  огромный
broad	brɔ:d	широкий,  обширный
garlic	'gɑ:lɪk	чеснок
fashion	'fæʃ(ə)n	очертания,  покрой (об одежде),  манера поведения
furious	'fjʊərɪəs	взбешённый
limp	lɪmp	хромать,  мягкий,  нежёсткий
south	saʊθ	юг
discover	dɪ'skʌvə	обнаруживать,  делать открытие
breach	bri:ʧ	брешь,  дыра
old	əʊld	старый
print	prɪnt	отпечаток,  след,  штамп
magic	'mæʤɪk	волшебство,  магия
ever	'evə	всегда,  когда-либо
flutter	'flʌtə	дрожание,  трепетание
desk	desk	рабочий стол,  парта
pension	'pen(t)ʃ(ə)n	пенсия,  пособие
accompany	ə'kʌmpənɪ	сопровождать,  следовать вместе,  аккомпанировать
december	dɪ'sembə	декабрь
where	(h)weə	где?,  куда?,  откуда?
diet	'daɪət	пища,  диета,  орган законодательной власти
plenty	'plentɪ	изобилие
handle	'hændl	рукоятка (ножа, молотка),  удобный случай
glad	glæd	довольный,  весёлый
nor	nɔ:	также не
wipe	waɪp	вытирать,  протирать
petal	'pet(ə)l	лепесток
persuade	pə'sweɪd	убеждать (в чём-л.)
fork	fɔ:k	вилка
pure	pjʊə	чистый,  беспримесный
sweater	'swetə	свитер,  тот кто потеет
remote	rɪ'məʊt	дальний,  отдалённый,  дистанционный
application	,æplɪ'keɪʃ(ə)n	просьба,  применение,  прикладывание
bonus	bəʊnəs	премия,  награда
trust	trʌst	вера,  доверие
moist	mɒɪst	сырой,  влажный
foot	fʊt	ступня,  лапа (животного)
supply	sə'plaɪ	снабжать (чем-л.),  добавлять (что-л. недостающее)
bicyclist	baɪsɪklɪst	велосипедист
assignment	ə'saɪnmənt	назначение,  распределение,  выделение
stick	stɪk	палка,  втыкать
thank	θæŋk	благодарить
ticket	'tɪkɪt	билет,  прикреплять ярлык
disqualify	dɪs'kwɒlɪfaɪ	дисквалифицировать,  лишать права
hen	hen	курица
next	nekst	следующий
depict	dɪ'pɪkt	изображать на картине,  рисовать
detain	dɪ'teɪn	задерживать,  арестовывать
basic	beɪsɪk	составляющий основу, сущность,  базисный
maybe	'meɪbɪ	может быть
mere	mɪə	простой,  всего лишь,  озеро
hydrogen	'haɪdrəʤən	водород
enough	ɪ'nʌf	достаточный
horror	'hɒrə	ужас,  страх
astronaut	æstrənɔ:t	астронавт,  космонавт
boom	bu:m	гудение,  шумная реклама
business	bɪznəs	дело,  занятие,  работа
pavement	'peɪvmənt	тротуар,  мостовая
neat	ni:t	чёткий,  точный,  бык,  корова
precious	'preʃəs	драгоценный
christmas	krɪsməs	Рождество Христово
charity	'ʧærɪtɪ	благотворительность,  милосердие
dispense	dɪ'spen(t)s	раздавать,   распределять
very	'verɪ	очень,  тот самый
bundle	bʌndl	вязанка,  пучок,  большое количество (чего-л.)
mat	mæt	половик,  матовая краска
able	eɪbl	способный,  знающий
leg	leg	нога (от бедра до ступни)
ago	ə'gəʊ	тому назад
split	splɪt	раскалывать
agenda	ə'ʤendə	программа (работы),  повестка дня
hoop	hu:p	обруч,  гиканье,  крик
screw	skru:	винт,  скряга,  кляча
persist	pə'sɪst	упорствовать,  настойчиво продолжать
allow	ə'laʊ	позволять,  разрешать
conversion	kən'vɜ:ʃ(ə)n	превращение,  изменение
oblige	ə'blaɪʤ	обязывать,  принуждать
january	'ʤænjʊ(ə)rɪ	январь
captain	kæptɪn	капитан
hero	'hɪərəʊ	герой
enable	ɪ'neɪbl	давать возможность (что-л. сделать)
apart	ə'pɑ:t	в стороне,  отдельно
establish	ɪs'tæblɪʃ	учреждать,  устанавливать (какой-л. факт)
vivid	'vɪvɪd	яркий,  живой
acrobatics	,ækrə'bætɪks	акробатика
bull	bʊl	бык,  буйвол,  Телец ( зодиак),  явная нелепость
sheet	ʃi:t	простыня,  лист,  обёртывать
loom	lu:m	ткацкий станок,  очертания (неясные),  тень
soldier	'səʊlʤə	солдат
young	jʌŋ	молодой
fun	fʌn	веселье,  забава
punctual	'pʌŋkʧʊəl	пунктуальный,  точный
bark	bɑ:k	кора (дерева),  лай,  барк (большое парусное судно)
egg	eg	яйцо
distract	dɪ'strækt	отвлекать,  уводить в сторону
ebony	'eb(ə)nɪ	чёрное дерево
brooch	brəʊʧ	брошь
bush	bʊʃ	куст
acquaint	ə'kweɪnt	знакомить с (кем-л.)
paradise	'pærədaɪs	рай
ice	aɪs	лёд,  замораживать
dine	daɪn	обедать
accessible	ək'sesəbl	доступный,  достижимый
basket	bɑ:skɪt	корзина,  кузов
consolidate	kən'sɒlɪdeɪt	объединять
bonnet	bɒnɪt	дамская шляпа,  капот (двигателя),  кожух
sheep	ʃi:p	овца,  робкий
extra	'ekstrə	добавочный,  дополнительный
home	həʊm	дом,  домашний очаг
throne	θrəʊn	трон,  престол
tune	tju:n	мелодия,  гармония
bankruptcy	bæŋkrʌptsɪ	банкротство,   несостоятельность
hostage	'hɒstɪʤ	заложник
groan	grəʊn	стон
cycle	'saɪkl	(хронологический) период,  круговой процесс
sacred	'seɪkrɪd	священный,  святой
preference	'pref(ə)r(ə)n(t)s	предпочтение,  преимущественное право
switch	swɪʧ	выключатель,  переключатель
plead	pli:d	защищать подсудимого,  обращаться к суду
agreement	ə'gri:mənt	согласие,  договор
comply	kəm'plaɪ	исполнять (просьбу, требование)
mode	məʊd	метод,  способ
nod	nɒd	кивать головой
shot	ʃɒt	выстрел,  попытка (сделать что-л.)
pious	'paɪəs	набожный
which	(h)wɪʧ	который?,  какой?  (в вопросах, подразумевающих выбор)
book	bʊk	книга,  записывать
file	faɪl	напильник,  папка,  идти гуськом
nose	nəʊz	нос,  морда
feminine	'femɪnɪn	женский,  принадлежащий женщине
reference	'ref(ə)r(ə)n(t)s	ссылка (на кого-л. / что-л.),  справочная информация
twist	twɪst	обхватывать,  сплетать,  выжимать (бельё)
resolute	'rez(ə)lu:t	решительный,  твёрдый
annual	ænjʊəl	ежегодный,  годовой
fortunate	'fɔ:ʧ(ə)nət	счастливый,  удачливый
surface	'sɜ:fɪs	поверхность
condition	kən'dɪʃ(ə)n	обстоятельства,  условия
globe	'gləʊb	шар,  планета
hip	hɪp	бедро,  шиповник,  уныние,  знающий толк в чём-л
nature	'neɪʧə	природа,  сущность,  характер
opposite	'ɒpəzɪt	находящийся напротив,  противоположный
blank	blæŋk	чистый,  неисписанный (бумага),  холостой (патрон)
observant	əb'zɜ:v(ə)nt	внимательный,  наблюдательный
occupy	'ɒkjʊpaɪ	захватывать,  завладевать
appear	ə'pɪə	появляться
hence	hen(t)s	отсюда,  прочь,  с этих пор
take	teɪk	брать
week	wi:k	неделя
aware	ə'weə	знающий
rind	raɪnd	кора,  шелуха
provide	prə'vaɪd	снабжать,  обеспечивать (кого-л. / что-л.)
noise	nɒɪz	шум
salary	'sæl(ə)rɪ	жалованье,  заработная плата (служащего)
breakfast	brekfəst	утренний завтрак
dock	dɒk	щавель,  пристань,  обрезать
husband	'hʌzbənd	муж,  разумно использовать (что-л.)
adjust	ə'ʤʌst	приводить в порядок
bishop	bɪʃəp	епископ,  слон (шахматная фигура)
blown	bləʊn	запыхавшийся,  еле переводящий дыхание
defend	dɪ'fend	защищать
applaud	ə'plɔ:d	аплодировать,  хлопать
scar	skɑ:	рубец,  шрам,  обрыв,  утёс
fatal	'feɪt(ə)l	неизбежный,  губительный
hostess	'həʊstɪs, ,həʊ'stes	хозяйка (дома)
valuable	'væljʊəbl	ценный
substance	'sʌbst(ə)n(t)s	вещество,  суть
tell	tel	говорить
depend	dɪ'pend	зависеть
alley	ælɪ	узкая улица
pound	paʊnd	фунт,  загон (для скота),  тяжёлый удар
quarrel	'kwɒr(ə)l	ссора,  алмаз для резки стекла
crude	kru:d	сырая нефть,  необработанный
boss	bɒs	хозяин,  выпуклость,  неразбериха
will	wɪl	вспомог. глагол будущего времени,  воля,  заставлять
maternity	mə'tɜ:nətɪ	материнство
join	ʤɒɪn	соединять
unconscious	ʌn'kɒn(t)ʃəs	неосознающий,  в обмороке
desire	dɪ'zaɪə	испытывать сильное желание,  жаждать
hockey	'hɒkɪ	хоккей
astonish	ə'stɒnɪʃ	изумлять
signature	'sɪgnəʧə	подпись
band	bænd	лента,  ремешок,  группа людей
naked	'neɪkɪd	голый
nitrogen	'naɪtrəʤən	азот
society	sə'saɪətɪ	общество
conception	kən'sepʃ(ə)n	осмысление,  понимание
rub	rʌb	тереться,  раздражать
butter	bʌtə	масло
slight	slaɪt	стройный,  тонкий,  пренебрегать
drought	draʊt	засуха
yankee	'jæŋkɪ	американец,  уроженец или житель Новой Англии
set	set	ставить,  класть
burial	berɪəl	похороны
cloud	klaʊd	облако,  омрачать
master	'mɑ:stə	хозяин,  мастер
intellect	'ɪntəlekt	разум
average	æv(ə)rɪʤ	средний,  обыкновенный
weak	wi:k	слабый,  хрупкий
glance	glɑ:n(t)s	взглянуть мельком,  сверкнуть
situated	'sɪtjʊeɪtɪd	расположенный,  находящийся в определённых условиях
sing	sɪŋ	петь
arouse	ə'raʊz	будить,  просыпаться
drug	drʌg	лекарство
under	'ʌndə	под,  ниже
soon	su:n	скоро
year	jɪə	год
applicant	æplɪk(ə)nt	кандидат,  проситель
pocket	'pɒkɪt	карман
bachelor	bæʧ(ə)lə	холостяк,  бакалавр
hypertension	,haɪpə'ten(t)ʃ(ə)n	повышенное кровяное давление
usage	'ju:sɪʤ	обычай,  привычка
stamp	stæmp	штамп,  ставить печать,  топнуть ногой
addressee	,ædre'si:	адресат,  получатель
grin	grɪn	скалить зубы,  ухмыляться
vacation	və'keɪʃ(ə)n	каникулы
bugle	bju:gl	горн,  сигнальная труба,  бисер
nun	nʌn	монахиня
snow	snəʊ	снег
flavour	'fleɪvə	вкус,  аромат
adorn	ə'dɔ:n	украшать,  быть украшением
above	ə'bʌv	наверху,  выше
actress	æktrəs	актриса
invade	ɪn'veɪd	вторгаться,  захватывать
argument	ɑ:gjəmənt	аргумент,  доказательство,  дискуссия
force	fɔ:s	водопад,  сила,  заставлять
footboard	'fʊtbɔ:d	подножка,  ступенька (железнодорожного вагона)
genius	'ʤi:nɪəs	гений,  дух,  одарённость
borrow	bɒrəʊ	занимать,  брать на время
road	rəʊd	дорога
wary	'weərɪ	осторожный
firm	fɜ:m	крепкий,  прочный,  фирма
pale	peɪl	забор,  огороженная территория,  бледный
anniversary	,ænɪ'vɜ:s(ə)rɪ	годовщина,  юбилей,  ежегодный
kitchen	'kɪʧɪn	кухня
utter	'ʌtə	издавать звук,  полный,  совершенный
coin	kɒɪn	монета,  штемпель
equal	'i:kwəl	равный,  одинаковый
purpose	'pɜ:pəs	цель,  замысел
better	betə	от good  лучший,  высший
unbutton	ʌn'bʌt(ə)n	расстёгивать
index	'ɪndeks	указатель,  каталог
overlook	,əʊvə'lʊk	смотреть сверху (на что-л.),  не заметить
conquest	'kɒŋkwest	завоевание,  покорение (народов, земель)
show	ʃəʊ	показывать
breast	brest	грудь,  молочная железа,  душа
gamble	'gæmbl	играть в азартные игры
absent-minded	,æbs(ə)nt'maɪndɪd	рассеянный
rent	rent	арендная плата,  отверстие
although	ɔ:l'ðəʊ	хотя,  несмотря на то, что
swallow	'swɒləʊ	глоток,  ласточка
treat	tri:t	обращаться,  вести себя (по отношению к кому-л),  удовольствие
parcel	'pɑ:s(ə)l	пакет,  свёрток,  делить на части,  частично
ground	graʊnd	земля,  почва
summer	'sʌmə	лето
black-board	blækbɔ:d	классная доска
row	rəʊ	ряд,  линия,  гребля,  прогулка на лодке,  сырой,  неготовый
appliance	ə'plaɪən(t)s	прибор,  приспособление,  пожарная машина
affair	ə'feə	дело,  происшествие
extension	ɪk'sten(t)ʃ(ə)n	удлинение,  вытягивание
each	i:ʧ	каждый
snore	snɔ:	храпеть (во сне),  спать
bill	bɪl	счёт за (что либо),  список,  законопроект,  клюв,  мыс
launch	lɔ:nʧ	спуск судна на воду,  начало (каких-л. действий)
believe	bɪ'li:v	верить
dispatch	dɪ'spæʧ	отправление,  отсылка (курьера, почты)
vision	'vɪʒ(ə)n	зрение,  зрелище
shape	ʃeɪp	форма,  очертание
bruise	bru:z	синяк,  помятость
hasty	'heɪstɪ	быстрый
condemn	kən'dem	осуждать,  порицать
cyclist	'saɪklɪst	велосипедист
licence	'laɪs(ə)n(t)s	разрешение,  позволение
bottom	bɒtəm	нижняя часть,  дно (моря, реки)
starve	stɑ:v	голодать,  умирать от голода
interview	'ɪntəvju:	деловая встреча,  деловая беседа
dye	daɪ	окраска
comprehensive	,kɒmprɪ'hen(t)sɪv	всесторонний,  полный
vain	veɪn	самодовольный,  тщетный,  пустой
when	(h)wen	когда? (в вопросительных предложениях)
wife	waɪf	жена
dark	dɑ:k	тёмный
ale	eɪl	пиво,  эль
summit	'sʌmɪt	вершина
quite	kwaɪt	вполне,  довольно,  почти
position	pə'zɪʃ(ə)n	положение,  позиция
jersey	'ʤɜ:zɪ	свитер
halt	hɔ:lt	остановка,  прекращение,  быть в нерешительности
manuscript	'mænjʊskrɪpt	манускрипт,  рукопись
implement	'ɪmplɪmənt	инструмент,  прибор,  выполнять
drive	draɪv	ехать (на автомобиле),  везти
rough	rʌf	грубый,  жёсткий (например о шерсти)
closet	'klɒzɪt	встроенный шкаф для одежды,  (рабочий) кабинет
delicious	dɪ'lɪʃəs	восхитительный,  прелестный
shelter	'ʃeltə	приют,  убежище
hope	həʊp	надеяться (на что-л.),  фьорд,  небольшой узкий залив
authority	ɔ:'θɒrɪtɪ	власть,  авторитет
tuesday	'tju:zdɪ	вторник
gas	gæs	газ,  бензин (амер)
abandon	ə'bændən	покидать,  оставлять
bless	bles	благословлять,  одаривать (кого-л. чем-л.)
mental	'ment(ə)l	психический,  умственный
chess	ʧes	шахматы,  оконная рама
level	'lev(ə)l	уровень,  степень,  плоский,  ровный
away	ə'weɪ	далеко,  давно,  прочь
hurry	'hʌrɪ	суматоха,  спешка
interpret	ɪn'tɜ:prɪt	объяснять
foreign	'fɒrɪn	иностранный
elm	elm	вяз
hose	həʊz	рукав,  шланг
dictionary	'dɪkʃ(ə)n(ə)rɪ	словарь
father-in-law	'fɑ:ðə(r)ɪnlɔ:	свёкор (отец мужа),  тесть (отец жены)
message	'mesɪʤ	сообщение,  донесение
bucket	bʌkɪt	ведро
aunt	ɑ:nt	тётя
verdict	'vɜ:dɪkt	вердикт,  решение присяжных заседателей
unrestricted	,ʌnrɪ'strɪktɪd	неограниченный
porter	'pɔ:tə	швейцар,  сторожевой пёс,  носильщик
blacksmith	blæksmɪθ	кузнец
invasion	ɪn'veɪʒ(ə)n	военное вторжение,  нашествие
mobile	'məʊbaɪl	подвижный,  мобильный
service	'sɜ:vɪs	служба,  государственная служба
game	geɪm	игра,  дичь,  добытый на охоте
fate	feɪt	судьба,  жребий
extreme	ɪks'tri:m	самый отдалённый,  крайний
eliminate	ɪ'lɪmɪneɪt	устранять,  исключать
vacant	'veɪk(ə)nt	незаполненный,  пустой
search	sɜ:ʧ	поиск,  обыск
rival	'raɪv(ə)l	соперник,  конкурент
auction	ɔ:kʃ(ə)n	аукцион,  торги
definite	'def(ə)nət	точный,  определённый
confusion	kən'fju:ʒ(ə)n	смущение,  беспорядок
buckle	bʌkl	пряжка,  скоба,  пирог с ягодами
constant	'kɒn(t)stənt	постоянная,  константа
bosom	bʊzəm	грудь,  пазуха,  недра
avoid	ə'vɒɪd	избегать,  уклоняться
lion	'laɪən	лев
proof	pru:f	подтверждение,  доказательство
satisfy	'sætɪsfaɪ	удовлетворять (кого-л., чьи-л. требования)
gulp	gʌlp	быстро глотать
aid	eɪd	помогать
plug	plʌg	пробка,  (пожарный) кран,  штепсельная вилка
beginning	bɪ'gɪnɪŋ	начало
bystreet	baɪstri:t	переулок
archipelago	,ɑ:kɪ'peləgəʊ	архипелаг,  группа островов
brittle	brɪtl	ломкий,  хрупкий
rail	reɪl	перила,  рельсы,  ругать
dozen	'dʌz(ə)n	дюжина,  изумлять,  притуплять чувства
scheme	ski:m	план,  схема,  рисунок
haste	heɪst	поспешность
once	wʌn(t)s	один раз,  когда-то
inspect	ɪn'spekt	внимательно осматривать
attentive	ə'tentɪv	внимательный,  заботливый
record	'rekɔ:d	запись,  письменная фиксация (каких-л. фактов)
billiards	bɪlɪədz	бильярд
ham	hæm	бедро,  окорок
antagonism	æn'tægənɪz(ə)m	вражда,  неприязнь
upwards	'ʌpwəds	вверх,  больше,  старше
sand	sænd	песок
discuss	dɪ'skʌs	обсуждать
accelerate	ək'seləreɪt	ускорять,  убыстрять
grumble	'grʌmbl	ворчать,  жаловаться
brown	braʊn	коричневый
bid	bɪd	предложение цены (на аукционе)
gulf	gʌlf	морской залив,  водоворот
happen	'hæp(ə)n	случаться,  происходить
bug	bʌg	клоп,  повальное увлечение
enrol	ɪn'rəʊl	вносить в список,  регистрировать
fiddle	'fɪdl	скрипка
cocoa	'kəʊkəʊ	какао (напиток)
heaven	'hev(ə)n	небеса,  небо
occasion	ə'keɪʒ(ə)n	возможность,  случай,  шанс
admiration	,ædmə'reɪʃ(ə)n	восторг,   изумление,  восхищение
visual	'vɪʒʊəl	зрительный,  видимый
boat	bəʊt	лодка,  шлюпка
county	'kaʊntɪ	графство,  округ
hour	aʊə	час
king	kɪŋ	король
nevertheless	,nevəðə'les	всё-таки,  тем не менее
lag	læg	отставание,  запаздывание,  заключённый
flat	flæt	плоская поверхность,  квартира
heavy	'hevɪ	тяжёлый,  тяжеловесный
peasant	'pez(ə)nt	крестьянин,  сельский житель
delay	dɪ'leɪ	откладывать,  отсрочивать
zenith	'zenɪθ	зенит,  кульминация
miserable	'mɪz(ə)rəbl	жалкий,  несчастный
threshold	'θreʃhəʊld	порог
crack	kræk	трещать,  скрипеть,  стрелять
encourage	ɪn'kʌrɪʤ	ободрять,  поощрять
victory	'vɪkt(ə)rɪ	победа
ray	reɪ	луч,  скат (рыба)
participate	pɑ:'tɪsɪpeɪt	принимать участие
casual	'kæʒwəl	случайный
certain	sɜ:t(ə)n	точный,  определённый,  некоторый
joke	ʤəʊk	шутка
acute	ə'kju:t	остроконечный,  острый,  сильный,  резкий
remark	rɪ'mɑ:k	замечание,  высказывание
resolve	rɪ'zɒlv	принимать решение,  решать голосованием
junction	'ʤʌŋkʃ(ə)n	соединение,  объединение
folly	'fɒlɪ	неосмотрительность,  глупость
apt	æpt	подходящий,  склонный
movie	'mu:vɪ	кинофильм
yes	jes	да
grow	grəʊ	расти,  вырастать
beaten	bi:tn	битый,  измученный,  кованый
verify	'verɪfaɪ	проверять
unfortunate	ʌn'fɔ:ʧ(ə)nət	неудачный
beforehand	bɪ'fɔ:hænd	преждевременный
rule	ru:l	правило,  норма
shoot	ʃu:t	стрелять,  распускаться (о почках),  росток
orphan	'ɔ:f(ə)n	сирота
chance	ʧɑ:n(t)s	случайность,  удача,  шанс
beam	bi:m	луч,  сияющий вид
repeat	rɪ'pi:t	повторять
indefinite	ɪn'def(ə)nət	неопределённый,  неясный
inceptive	ɪn'septɪv	начальный,  зарождающийся
broadcast	brɔ:dkɑ:st	радио,  радиовещание
caviar	'kævɪɑ:	икра (рыбья)
bump	bʌmp	глухой тяжёлый удар,  столкновение
plunge	plʌnʤ	нырять,  окунаться
candy	'kændɪ	леденец,  конфета,  варить в сахаре
lens	lenz	линза,  объектив
advertisement	əd'vɜ:tɪsmənt	объявление,  реклама
stir	stɜ:	шевелиться,  двигаться,  тюрьма
bribe	braɪb	взятка,  стимул
denote	dɪ'nəʊt	отмечать (знаком),  обозначать
suffer	'sʌfə	страдать,  терпеть
demand	dɪ'mɑ:nd	требовать
cheap	ʧi:p	дешёвый
miscellaneous	,mɪs(ə)'leɪnɪəs	смешанный,  разнообразный
stumble	'stʌmbl	спотыкаться,  ошибиться
amateur	æmətə	любитель,  поклонник
swan	swɒn	лебедь,  бард,  поэт
turn	tɜ:n	поворачиваться
lathe	leɪð	токарный станок
angler	ænglə	рыбак
any	enɪ	всякий,  любой
animal	ænɪm(ə)l	животное,  зверь
cabbage	kæbɪʤ	капуста,  шпаргалка,  воровать
arena	ə'ri:nə	арена (в цирке),  сфера интересов,  место действия
ardour	ɑ:də	жар,  пыл,  рвение
reckon	'rek(ə)n	считать, вычислять,  полагать
allude	ə'lu:d	упоминать,  намекать
detail	'di:teɪl	подробность,  деталь
whisper	'(h)wɪspə	шёпот
pork	pɔ:k	свинина
advise	əd'vaɪz	советовать
train	treɪn	тренироваться,  тянуть,  поезд
elephant	'elɪfənt	слон
cabinet	kæbɪnət	кабинет министров,  шкаф с выдвижными ящиками
angry	æŋgrɪ	сердитый,  недовольный
fresh	freʃ	свежий (недавно приготовленный)
pink	pɪŋk	гвоздика,  розовый,  прокалывать
shelf	ʃelf	полка,  отмель,  шельф
consume	kən'sju:m	истреблять,  уничтожать (обычно об огне)
cotton	'kɒt(ə)n	хлопок
ominous	'ɒmɪnəs	предсказывающий,  предвещающий
undermine	,ʌndə'maɪn	делать подкоп,  минировать
member	'membə	член (какой-л. организации)
list	lɪst	список,  каталог,  наклон,  кромка
compile	kəm'paɪl	выбирать информацию, собирать материал (из разных источников)
expose	ɪk'spəʊz	делать видимым,  показывать
capture	'kæpʧə	захват,  поимка
consist	kən'sɪst	заключаться в чём-л.,  быть составленным из
liver	'lɪvə	человек,  существо,  печень
habit	'hæbɪt	обычай,  традиция,  одежда для специальных случаев
emerge	ɪ'mɜ:ʤ	появляться
customer	'kʌstəmə	покупатель
shout	ʃaʊt	кричать
meal	mi:l	мука,  еда
villain	'vɪlən	злодей,  негодяй
compensate	'kɒmpenseɪt	расплачиваться,  вознаграждать
diamond	'daɪəmənd	алмаз,  бриллиант,  бубны (карт)
budget	bʌʤɪt	бюджет,  финансовая смета
that	ðæt	тот
earn	ɜ:n	зарабатывать
linen	'lɪnɪn	полотно,  холст
automobile	ɔ:təmə(ʊ)bi:l	автомашина,  автомобиль
release	rɪ'li:s	избавлять,  увольнять (с работы),  публиковать
except	ɪk'sept	исключать,  возражать
anchor	æŋkə	якорь
puzzle	'pʌzl	вопрос ставящий в тупик,  головоломка
step	step	шаг
proverb	'prɒvɜ:b	пословица
parlour	'pɑ:lə	гостиная,  общая комната (в квартире)
bathroom	bɑ:θru:m	ванная комната,  туалет (в США)
town	taʊn	город
thirty	'θɜ:tɪ	тридцать
numerous	'nju:m(ə)rəs	многочисленный,  гармоничный,  созвучный
village	'vɪlɪʤ	деревня,  посёлок
plot	plɒt	участок земли,  заговор,  сюжет
constituent	kən'stɪtjʊənt	компонент,  составная часть
exact	ɪg'zækt	точный,  строгий
upstairs	ʌp'steəz	вверх (по лестнице),  верхний этаж
mandate	'mændeɪt	мандат,  поручение
flesh	fleʃ	тело,  мякоть (плода),  плоть
tooth	tu:θ	зуб
jew	ʤu:	еврей,  иудей
word	wɜ:d	слово,  выражать словами
unfamiliar	,ʌnfə'mɪlɪə	незнакомый
kangaroo	,kæŋg(ə)'ru:	кенгуру
cough	kɒf	кашель
warm	wɔ:m	тёплый,  нагревать
revise	rɪ'vaɪz	проверять,  исправлять
artist	ɑ:tɪst	художник,  профессиональный музыкант
comment	'kɒment	комментарий,  замечание
independence	,ɪndɪ'pendən(t)s	автономия,  независимость
storage	'stɔ:rɪʤ	хранение,  накопление
handwriting	'hænd,raɪtɪŋ	почерк
scarcely	'skeəslɪ	едва,  почти не
porch	pɔ:ʧ	крыльцо,  веранда
apply	ə'plaɪ	обращаться с просьбой,  применять к (чему-л.)
precaution	prɪ'kɔ:ʃ(ə)n	предосторожность,  предусмотрительность
muffler	'mʌflə	тёплый шарф,  рукавица,  глушитель
ox	ɒks	бык
betray	bɪ'treɪ	изменять,  предавать
attend	ə'tend	посещать,   присутствовать,  прислуживать
guardian	'gɑ:dɪən	опекун,  попечитель
pretty	'prɪtɪ	милый,  прелестный
draw	drɔ:	рисовать,  тащить
result	rɪ'zʌlt	результат,  проистекать (из чего-л.)
figurine	'fɪgjʊri:n	статуэтка
institute	'ɪn(t)stɪtju:t	институт,  установленная практика,  система
pavilion	pə'vɪljən	палатка,  тент
loss	lɒs	потеря,  лишение
stair	steə	ступенька,  лестница
wholesome	'həʊls(ə)m	полезный,  благотворный
neither	'naɪðə	ни тот ни другой,  никто (из двух)
choice	ʧɒɪs	выбор
article	ɑ:tɪkl	статья (в газете),  параграф
mountain	'maʊntɪn	гора
baptize	bæp'taɪz	крестить,  давать название
somebody	'sʌmbədɪ	кто-нибудь
bulwark	bʊlwək	вал,  бастион
helicopter	'helɪkɒptə	вертолёт
image	'ɪmɪʤ	образ,  изображение,  отражение (в зеркале)
oil	ɒɪl	масло (обычно растительное или минеральное)
fine	faɪn	превосходный,  штраф
grape	greɪp	виноград
meadow	'medəʊ	луг
river	'rɪvə	река
careful	keəf(ə)l	заботливый,  аккуратный
refresh	rɪ'freʃ	освежать,  повторять
down	daʊn	вниз,  пух,  возвышенность
baritone	bærɪtəʊn	баритон
alive	ə'laɪv	живой,  энергичный
condense	kən'den(t)s	уплотнять,  сгущать
visible	'vɪzəbl	видимый,  явный
slide	slaɪd	скользить,  делать что-л. незаметно
lay	leɪ	класть,  положить,  светский
product	'prɒdʌkt	продук,  изделие
midday	,mɪd'deɪ	полдень
approve	ə'pru:v	одобрять
mine	maɪn	мой,  моя,  моё,  шахта
exert	ɪg'zɜ:t	приводить в действие,  прилагать усилия
injury	'ɪnʤ(ə)rɪ	вред,  повреждение
nursery	'nɜ:s(ə)rɪ	детская (комната)
plate	pleɪt	тарелка,  пластинка,  табличка
asian	eɪʃ(ə)n	азиатский,  относящийся к Азии
urge	ɜ:ʤ	подгонять,  заставлять
allergy	æləʤɪ	аллергия
voyage	'vɒɪɪʤ	плавание,  морское путешествие
station	'steɪʃ(ə)n	место,  железнодорожная станция
flight	flaɪt	полёт,  пролёт лестницы
church	ʧɜ:ʧ	церковь
maintain	meɪn'teɪn	поддерживать,  сохранять
within	wɪ'ðɪn	в,  внутри (выражает отношения места)
witty	'wɪtɪ	остроумный
yet	jet	ещё,  всё ещё
petition	pə'tɪʃ(ə)n	прошение,  ходатайство
much	mʌʧ	много
venture	'venʧə	рисковать (чем-л.)
tender	'tendə	предлагать (что-л.),  нежный,  сторож
collapse	kə'læps	сильно ослабеть,  разрушаться
pardon	'pɑ:d(ə)n	извинение,  прощение
unlucky	ʌn'lʌkɪ	неудачный
work	wɜ:k	работа
contempt	kən'tempt	презрение (к кому-л.)
season	'si:z(ə)n	время года,  сезон
make	meɪk	делать,  создавать
disaster	dɪ'zɑ:stə	беда,  несчастье
youth	ju:θ	юность
strict	strɪkt	строгий,  точный
kit	kɪt	набор,  снаряжение,  котёнок
verge	vɜ:ʤ	край,  грань
swamp	swɒmp	болото,  затоплять
none	nʌn	ни один из (общего числа)
neck	nek	шея,  воротник,  сжимать
pump	pʌmp	насос,  туфля-лодочка
approval	ə'pru:v(ə)l	одобрение
art	ɑ:t	искусство
detach	dɪ'tæʧ	отделять
patient	'peɪʃ(ə)nt	терпеливый,  пациент
wrong	rɒŋ	неправильный,  неверный,  наносить ущерб
crane	kreɪn	журавль,  подъёмный кран
wild	waɪld	дикий (о животных,  растениях)
tape	teɪp	ленточка,  связывать верёвкой
temporary	'temp(ə)r(ə)rɪ	временный
please	pli:z	радовать,  доставлять удовольствие,  пожалуйста!
laxative	'læksətɪv	слабительное (средство)
ferry	'ferɪ	переправа,  паром
salt	sɔ:lt	соль
square	skweə	квадрат
lip	lɪp	губа
berry	berɪ	ягода,  зёрнышко икры
baby	beɪbɪ	ребёнок
same	seɪm	тот (же) самый,  одинаковый
even	'i:v(ə)n	вечер,  плоский,  ровный (о местности)
arbitrary	ɑ:bɪtr(ə)rɪ	произвольный,  случайный
mystery	'mɪst(ə)rɪ	тайна,  загадка
nuclear	'nju:klɪə	ядерный
military	'mɪlɪt(ə)rɪ	военный,  армейский
harvest	'hɑ:vɪst	жатва,  урожай
with	wɪð	с,  вместе с (указывает на связь, совместность)
highlight	'haɪlaɪt	отводить главное место,  выделять
strange	streɪnʤ	чужой,  странный
sink	sɪŋk	приспособление для стока воды,  сточная труба
award	ə'wɔ:d	присуждать,  назначать ( премию)
unequal	ʌn'i:kw(ə)l	неравный,  неодинаковый
elegant	'elɪgənt	изысканный,  элегантный (об одежде)
freedom	'fri:dəm	независимость,  свобода
all	ɔ:l	всё,  наибольший
colour	'kʌlə	цвет,  оттенок,  краска
match	mæʧ	спичка,  пара (предметов, людей)
goods	gʊdz	товар,  вещи
gunpowder	'gʌn,paʊdə	чёрный порох
flame	fleɪm	огонь,  пламя
across	ə'krɒs	поперёк,  в ширину,  крест-накрест
grand	grænd	большой,  величественный
hygiene	'haɪʤi:n	гигиена
bias	baɪəs	наклон,  склон
peel	pi:l	кожица,  тонкий слой с поверхности (чего-л.)
drawer	'drɔ:ə	чертёжник,  бармен
blockade	blɒ'keɪd	блокада
spread	spred	распространение,  расширение,  намазывать
lease	li:s	аренда,  сдача внаём
paste	peɪst	клей,  паста
disturb	dɪ'stɜ:b	тревожить,  беспокоить
sweat	swet	пот
became	bɪ'keɪm	прош.вр. become - становиться
butterfly	bʌtəflaɪ	бабочка
deplore	dɪ'plɔ:	оплакивать
they	ðeɪ	они
indeed	ɪn'di:d	в самом деле,  действительно
ware	weə	товары,  знающий,  осторожный
breed	bri:d	племя,  порода,  разводить (животных)
daughter-in-law	'dɔ:təɪnlɔ:	жена сына,  невестка,  сноха
middle	'mɪdl	середина,  центр
collar	'kɒlə	воротник,  ожерелье,  ошейник
hereditary	he'redɪt(ə)rɪ	наследственный, потомственный
outbreak	'aʊtbreɪk	вспышка,  бунт
corrupt	kə'rʌpt	испорченный,  коррумпированный
mouse	maʊs	мышь
ugly	'ʌglɪ	уродливый
genuine	'ʤenjʊɪn	истинный,  подлинный
either	'aɪðə	любой (из двух),  один из двух
scent	sent	запах,  аромат
spur	spɜ:	шпора (на обуви)
rocket	'rɒkɪt	ракета,  ночная фиалка (Hesperis matronalis)
orient	'ɔ:rɪənt	Восток,  страны Востока (особенно Китай и Япония)
invent	ɪn'vent	изобретать,  выдвигать что-л. новое
extent	ɪk'stent	пространство,  расстояние
between	bɪ'twi:n	между
great	greɪt	большой
darling	'dɑ:lɪŋ	дорогой,  любимый
equipment	ɪ'kwɪpmənt	оборудование
clash	klæʃ	сталкиваться,  громыханье (кастрюль)
exterior	ɪk'stɪərɪə	наружный,  внешний
title	'taɪtl	заглавие,  называть
straight	streɪt	прямой
kiss	kɪs	поцелуй
departure	dɪ'pɑ:ʧə	отъезд,  уход
meeting	'mi:tɪŋ	собрание,  встреча
settle	'setl	урегулировать ( конфликт),  принять решение
external	ɪk'stɜ:n(ə)l	внешний
careless	keələs	небрежный,  невнимательный
scientific	,saɪən'tɪfɪk	научный
hollow	'hɒləʊ	пустой,  голодный
coach	kəʊʧ	карета ,  экипаж,  тренер
tough	tʌf	жёсткий,  плотный
bargain	bɑ:gɪn	соглашение,  торговая сделка,  торговаться
presently	'prez(ə)ntlɪ	лично,  собственной персоной,  сейчас,  теперь
capable	'keɪpəbl	(of) способный на что-л.
harp	hɑ:p	арфа,  губная гармоника
deer	dɪə	олень,  лань
lamppost	'læmppəʊst	фонарный столб
assistance	ə'sɪst(ə)n(t)s	помощь
unit	'ju:nɪt	единица,  часть,  элемент
box	bɒks	коробка,  сундук,  удар кулаком
ace	eɪs	очко выигранное одним ударом (в теннисе),  туз,  ас
honour	'ɒnə	слава,  почёт
dodge	dɒʤ	обман,  хитрость,  уклоняться (от удара)
surprise	sə'praɪz	удивление
court	kɔ:t	суд,  судья
bet	bet	пари,  выбор
startle	'stɑ:tl	испугать,  побуждать (к действию)
analysis	ə'næləsɪs	анализ,  изучение
anticipation	æn,tɪsɪ'peɪʃ(ə)n	ожидание,  предчувствие
blow	bləʊ	веять,  дуть (о ветре),  цвести,  удар
passion	'pæʃ(ə)n	страсть,  пыл
breathe	bri:ð	дышать,  негромко говорить
monument	'mɒnjʊmənt	памятник,  монумент
seem	si:m	казаться,  представляться
fast	fɑ:st	пост (рел.),  быстрый,  крепкий
sweep	swi:p	мести,  подметать
sunday	'sʌndeɪ, 'sʌndɪ	воскресенье
belong	bɪ'lɒŋ	принадлежать (кому-л.)
irritate	'ɪrɪteɪt	сердить,  надоедать
intermediary	,ɪntə'mi:dɪərɪ	посредник
applause	ə'plɔ:z	аплодисменты,  одобрение
parent	'peər(ə)nt	один из родителей,  покровитель
wash	wɒʃ	мыть
bracket	brækɪt	бра,  держатель,  скобка
enslave	ɪn'sleɪv	порабощать,  делать рабом
clothes	kləʊðz	одежда
abundant	ə'bʌndənt	обильный,  богатый
anaesthesia	,ænəs'θi:zɪə	анестезия,  обезболивание
beef	bi:f	говядина,  жаловаться
wing	wɪŋ	крыло,  лететь
bother	bɒðə	беспокойство,  надоедать
ornament	'ɔ:nəmənt	украшение
frail	freɪl	тростник,  корзина (для сухофруктов),  ломкий
miss	mɪs	потеря,  отсутствие,  госпожа
scarf	skɑ:f	шарф,  галстук,  фаска,  паз
denial	dɪ'naɪəl	отказ (кому-л. в чём-л.),  отрицание
classify	'klæsɪfaɪ	классифицировать,  систематизировать
audible	ɔ:dəbl	слышный
meaning	'mi:nɪŋ	значение,  смысл
wire	'waɪə	проволока,  телеграф
mosquito	mɒs'ki:təʊ	москит,  комар
wallet	'wɒlɪt	бумажник
glacier	'glæsɪə	ледник
dear	dɪə	дорогой,  милый
mend	mend	чинить,  ремонтировать
blind-alley	blaɪnd'ælɪ	безвыходный,  безнадёжный
wind	wɪnd   waɪnd	1) ветер,  2) виться, извиваться
tap	tæp	пробка,  кран (водопроводный),  стучать
easy	'i:zɪ	лёгкий,  нетрудный
durable	'djʊərəbl	надёжный,  прочный
mutiny	'mju:t(ə)nɪ	мятеж,  бунт
despite	dɪ'spaɪt	злоба,  презрение,  несмотря на
rise	raɪz	вставать,  подниматься
volunteer	,vɒlən'tɪə	доброволец
aggravate	ægrəveɪt	усугублять,  ухудшать,  усиливать
kill	kɪl	убивать
useful	'ju:sf(ə)l	полезный,  пригодный,  успешный
shield	ʃi:ld	щит,  защита
half	hɑ:f	половина
pleat	pli:t	складка (на платье или драпировке)
slender	'slendə	стройный,  тонкий (о человеке)
inflammation	,ɪnflə'meɪʃ(ə)n	воспламенение,  возгорание
barge	bɑ:ʤ	баржа,  передвигаться  неуклюже,  спор
unity	'ju:nətɪ	единство,  сплочённость
edit	'edɪt	редактировать,  готовить к печати
vocal	'vəʊk(ə)l	вокальное произведение,  голосовой
life	laɪf	жизнь,  существование
merchant	'mɜ:ʧ(ə)nt	купец,  торговец
amnesty	æmnəstɪ	амнистия,  прощение
ring	rɪŋ	кольцо,  окружать,  звенеть
near	nɪə	ближний,  рядом
forecast	'fɔ:kɑ:st	предсказание
outstrip	,aʊt'strɪp	обгонять
activity	æk'tɪvətɪ	активность,  проявление работы каких-л. органов,  сил природы
conceive	kən'si:v	постигать,  понимать
suit	su:t, sju:t	костюм,  масть (карты),  подходить
attorney	ə'tə:nɪ	поверенный,  доверенное лицо,  адвокат,  прокурор
science	'saɪən(t)s	наука
preface	'prefəs	предисловие,  вводная часть
call	kɔ:l	кричать,  звонить по телефону
silent	'saɪlənt	молчащий
cunning	'kʌnɪŋ	хитрость,  коварство
utmost	'ʌtməʊst	самый отдалённый,  крайний
actor	æktə	актер
choke	ʧəʊk	душить,  сдавливать
prosecute	'prɒsɪkju:t	преследовать в судебном порядке,  предъявлять иск
breadth	bredθ	ширина,  полотнище
belief	bɪ'li:f	вера,  доверие
spend	spend	тратить,  расходовать (на что-л.)
double	'dʌbl	двойной,  в два раза больший
unanimous	ju:'nænɪməs	единогласный,  единодушный
bye-bye	baɪbaɪ	сон,  время спать
incite	ɪn'saɪt	подстрекать к (чему-л.)
background	bækgraʊnd	задний план,  фон,  исходные данные
reward	rɪ'wɔ:d	награда
cat	kæt	кот,  сварливая женщина
help	help	помогать
unable	ʌn'eɪbl	неспособный
anew	ə'nju:	ещё,  опять,  снова
dove	dʌv	голубь,  милый
compartment	kəm'pɑ:tmənt	отделение,  отсек,  салон (самолёта)
dust	dʌst	пыль,  суматоха
castle	kɑ:səl	замок,  дворец,  ладья (шахм),  делать рокировку
simple	'sɪmpl	простой
railroad	'reɪlrəʊd	железная дорога,  заставлять
reproach	rɪ'prəʊʧ	бранить,  упрекать
farewell	'feə'wel	прощание
handy	'hændɪ	доступный,   под рукой,  удобный
disguise	dɪs'gaɪz	изменять внешность,  маскировать
elevator	'elɪveɪtə	грузоподъёмник,  лифт
idea	aɪ'dɪə	идея,  мысль
negative	'negətɪv	отрицательный,  негативный
citizen	'sɪtɪz(ə)n	гражданин,  горожанин
conscious	'kɒn(t)ʃəs	сознательный,  осознанный
asleep	ə'sli:p	спящий
beak	bi:k	клюв,  хоботок (насекомых),  носик (чайника)
vulgar	'vʌlgə	грубый,  вульгарный
obstruct	əb'strʌkt	преграждать,  мешать (развитию)
course	kɔ:s	курс,  течение (реки),  образ действия
carpet	'kɑ:pɪt	ковёр,  покрывать (чем-л.)
gown	gaʊn	платье (женское),  римская тога,  одеваться
register	'reʤɪstə	журнал (записей),  официальный список
serve	sɜ:v	служить,  быть слугой
change	ʧeɪnʤ	менять,  заменять
glide	glaɪd	скольжение (по льду)
jerk	ʤɜ:k	резкое движение,  толчок,  вялить мясо
familiar	fə'mɪlɪə	хорошо знакомый, привычный
author	ɔ:θə	автор
sign	saɪn	знак,  символ,  подписывать (документ)
sensible	'sen(t)sɪbl	благоразумный,  здравомыслящий
rational	'ræʃ(ə)n(ə)l	разумный,  рациональный
zoo	zu:	зоопарк
airfield	eəfi:ld	аэродром
pen	pen	перо (писчее),  небольшой загон (для скота, птицы)
bind	baɪnd	завязывать
municipal	mju:'nɪsɪp(ə)l	городской,  муниципальный
cream	kri:m	сливки,  крем (кушанье),  лучшая часть
blaze	bleɪz	пламя,  метка на дереве,  = blaze abroad разглашать
landscape	'læn(d)skeɪp	ландшафт,  пейзаж
attachment	ə'tæʧmənt	привязанность,  дополнительное приспособление
wicked	'wɪkɪd	злой,  злобный
interest	'ɪnt(ə)rəst	интерес,  увлечённость
blackmail	blækmeɪl	шантаж,   вымогательство
lie	laɪ	ложь,  быть расположенным,  лежать
pay	peɪ	платить
give	gɪv	давать
lift	lɪft	возвышенность,  подъём
sharp	ʃɑ:p	острый
saint	seɪnt	святой
immortal	ɪ'mɔ:t(ə)l	вечный,  бессмертный
canal	kə'næl	канал (искусственный)
funeral	'fju:n(ə)rəl	похороны
fit	fɪt	подгонка (об одежде)
bee	bi:	пчела
pot	pɒt	горшок,  кастрюля
lavatory	'lævət(ə)rɪ	туалет,  прачечная,  сосуд для омовений
page	peɪʤ	лист,  страница,  паж
ride	raɪd	езда (верхом, на машине),  верховая лошадь
equip	ɪ'kwɪp	снаряжать,  экипировать
express	ɪk'spres	изображать,  выжимать (сок)
possess	pə'zes	владеть,  иметь
colleague	'kɒli:g	коллега,  сослуживец
sting	stɪŋ	жало,  кусаться
darn	dɑ:n	штопать,  ничтожное количество,  проклинать
volume	'vɒlju:m	объём,  вместительность,  уровень громкости
curl	kɜ:l	локон,  завиток
anticipate	æn'tɪsɪpeɪt	ожидать,  предвидеть
shoulder	'ʃəʊldə	плечо,  выступ
instruct	ɪn'strʌkt	инструктировать,  обучать
decision	dɪ'sɪʒn	решение (сделать что-л.)
cruel	'kru:əl	жестокий
else	els	ещё,  кроме
cheer	ʧɪə	одобрительное восклицание,  Браво!
arch	ɑ:ʧ	арка,  дуга
annoy	ə'nɒɪ	раздражать
depth	depθ	глубина (измеряемая от поверхности до дна)
bit	bɪt	кусочек,   частица,  зубило,  лезвие
let	let	позволять,  разрешать (кому-л. что-л.)
uncommon	ʌn'kɒmən	редкий,  необычный
hesitate	'hezɪteɪt	колебаться,  сомневаться
raise	reɪz	поднимать,  будить
string	strɪŋ	верёвка,  завязывать
poster	'pəʊstə	афиша,  плакат
sun	sʌn	солнце
flush	flʌʃ	внезапный прилив,  наводнение
vehicle	'vɪəkl	транспортное средство
dive	daɪv	нырять
sunk	sʌŋk	ниже уровня,  погруженный
republic	rɪ'pʌblɪk	республика
brigade	brɪ'geɪd	бригада
tool	tu:l	оборудование,  орудие труда
connect	kə'nekt	соединять,  выстраивать логическую цепочку
aside	ə'saɪd	в сторону,  отдельно
column	'kɒləm	колонна,  поддержка
pepper	'pepə	перец
store	stɔ:	запас,  резерв,  сохранять
bath	bɑ:θ	ванна,  купать
grain	greɪn	зерно,  хлебные злаки
foresee	fɔ:'si:	предвидеть
grateful	'greɪtf(ə)l, 'greɪtfʊl	благодарный,  признательный
penknife	'pennaɪf	перочинный нож
value	'vælju:	ценность,  значение
pool	pu:l	лужа,  общий фонд
artificial	,ɑ:tɪ'fɪʃ(ə)l	искусственный,  ненатуральный
verbatim	vɜ:'beɪtɪm	дословно
cavity	'kævətɪ	впадина,  яма
because	bɪ'kɒz	потому что,  так как
archaic	ɑ:'keɪɪk	архаичный,  устаревший
face	feɪs	лицо
undesirable	,ʌndɪ'zaɪərəbl	нежелательный
beauty	bju:tɪ	красота
attitude	ætɪtju:d	позиция,  отношение (about, of, to, towards)
stupid	'stju:pɪd	глупый
banquet	bæŋkwɪt	банкет,  торжественный обед
during	'djʊərɪŋ	в течение,  во время
essay	'eseɪ	испытание,  тест
architecture	ɑ:kɪtekʧə	архитектура,  зодчество
debt	det	долг
wander	'wɒndə	бродить,  странствовать
admire	əd'maɪə	любоваться,  восхищаться
co-ordinate	kəʊ'ɔ:dɪnət	одинаковый или равный по значению,  согласовывать
xerox	'zɪərɒks	"Ксерокс" (товарный знак)
chap	ʧæp	парень,  трещина,  щель
child	ʧaɪld	ребёнок
vest	vest	жилет,  наделять правом
absent	æbs(ə)nt	отсутствующий
asphalt	æsfælt	асфальт,  битум
elder	'eldə	старший (по возрасту),  бузина
side	saɪd	сторона
bowling	bəʊlɪŋ	игра в кегли,  боулинг
propose	prə'pəʊz	предлагать
steel	sti:l	сталь
confuse	kən'fju:z	смешивать,  путать (with) ,  приводить в беспорядок
skin	skɪn	кожа,  шкура
sorrow	'sɒrəʊ	горе,  печаль
beware	bɪ'weə	беречься,  опасаться
september	sep'tembə	сентябрь
winter	'wɪntə	зима
moustache	mə'stɑ:ʃ	усы
brain	breɪn	мозг,  размозжить голову
lump	lʌmp	глыба,  большое количество,  опухоль,  бугор
consumption	kən'sʌm(p)ʃ(ə)n	потребление,  расход
decline	dɪ'klaɪn	спускаться вниз (о поверхности),  ухудшение
pain	peɪn	боль
stream	stri:m	поток,  течение
nap	næp	дремота,  ворс (на сукне),  чашка,  сквозняк,  воровать
respect	rɪ'spekt	уважение,  почёт
birch	bɜ:ʧ	берёза,  розга,  сечь розгами
reverse	rɪ'vɜ:s	перевёртывать,  ставить с ног на голову,  отменять
wall	wɔ:l	стена
carry_out	kærɪ	выполнять,  осуществлять
armament	ɑ:məmənt	вооружение
frog	frɒg	лягушка,  отделка на одежде из тесьмы,  аксельбант
minority	maɪ'nɒrətɪ	меньшинство,  несовершеннолетие
combine	kəm'baɪn	объединять,  сочетать
vegetable	'veʤ(ə)təbl	овощ,  растение
owner	'əʊnə	владелец,  хозяин
fiction	'fɪkʃ(ə)n	выдумка,  сказка
grief	gri:f	горе,  печаль
african	æfrɪkən	африканский
storey	'stɔ:rɪ	этаж,  ярус
advice	əd'vaɪs	совет,  рекомендация
enormous	ɪ'nɔ:məs	громадный,  гигантский
educate	'eʤʊkeɪt, 'edjʊkeɪt	воспитывать,  обучать
legal	'li:g(ə)l	правовой,  законный
butcher	bʊʧə	мясник,  убийца
hurt	hɜ:t	ушиб,  рана
everywhere	'evrɪweə	везде
custom	'kʌstəm	обычай,  привычка,  таможня,  постоянные покупатели
build	bɪld	внешний вид,  стиль,  строение
rear	rɪə	воспитывать (детей),  выращивать (растения),  задняя часть
nurse	nɜ:s	няня,  медицинская сестра
sofa	'səʊfə	диван,  софа
appeal	ə'pi:l	призыв,  просьба,  привлекательность
shade	ʃeɪd	тень
dairy	'deərɪ	маслодельня,  молочное хозяйство
guest	gest	гость,  клиент
device	dɪ'vaɪs	приспособление,  механизм
mow	maʊ	гримаса,  стог
strap	stræp	ремень,  править бритву на ремне
pane	peɪn	оконное стекло
repulse	rɪ'pʌls	отражать,  отбивать (атаку)
pig	pɪg	свинья,  кабан
natural	'næʧ(ə)r(ə)l	естественный,  природный
abstain	əb'steɪn	воздерживаться
living-room	'lɪvɪŋrʊm	гостиная,  общая комната
clear	klɪə	светлый,  прозрачный
despise	dɪ'spaɪz	презирать
exceed	ɪk'si:d	превышать,  превосходить (кого-л. в чём-л.)
direct	dɪ'rekt	прямой
form	fɔ:m	форма,  внешний вид
wood	wʊd	лес
charm	ʧɑ:m	шарм,  обаяние,  талисман,  околдовывать
quality	'kwɒlətɪ	качество
pin	pɪn	штырь,  болт,  булавка,  прикалывать
keep	ki:p	держать
temple	'templ	храм,  церковь,  висок
crowd	kraʊd	толпа,  давить,  толкать
beast	bi:st	зверь,  грубый
fraud	frɔ:d	обман,  мошенничество
refer	rɪ'fɜ:	направлять,  отсылать (к кому-л. / чему-л.)
centenary	sen'ti:n(ə)rɪ	век,  столетие
guess	ges	гадать,  догадываться,  отгадать
protect	prə'tekt	защищать,  охранять
buy	baɪ	покупать
fowl	faʊl	птица,  дичь
council	'kaʊn(t)s(ə)l	совет (орган государственной власти)
betrayal	bɪ'treɪəl	измена,  предательство
amusing	ə'mju:zɪŋ	забавный
grant	grɑ:nt	дарить,  давать дотацию
newspaper	'nju:s,peɪpə	газета
antique	æn'ti:k	старинная вещь,  античный
tunnel	'tʌn(ə)l	тоннель
hat	hæt	шляпа
finger	'fɪŋgə	палец (на руке),  дотрагиваться
out	aʊt	вне,  снаружи,  за пределами (чего-л.)
bronze	brɒnz	бронза
via	'vaɪə	через,  сквозь,  посредством (чего-л.)
paint	peɪnt	рисунок,  краска,  грим
practice	'præktɪs	практика,  привычка
admit	əd'mɪt	допускать,  соглашаться
alcohol	ælkəhɒl	алкоголь,  спирт
broken	brəʊk(ə)n	разбитый,  сломанный
marry	'mærɪ	жениться (на ком-л.)
extinguish	ɪk'stɪŋgwɪʃ	гасить,  ликвидировать (пожар)
mean	mi:n	намереваться,  середина,  убогий,  захудалый
flask	flɑ:sk	фляжка
grade	greɪd	стадия,  этап
razor	'reɪzə	бритва
heap	hi:p	куча
cousin	'kʌz(ə)n	двоюродный брат,  кузен
motive	'məʊtɪv	мотив,  стимул
almost	ɔ:lməʊst	почти
barrel	bær(ə)l	бочка,  брюхо (лошади),  накапливать
competition	,kɒmpə'tɪʃ(ə)n	соревнование
height	haɪt	высота
contemporary	kən'temp(ə)r(ə)rɪ	современник,  ровесник
peacock	'pi:kɒk	павлин
destroy	dɪ'strɒɪ	разрушать
mouth	maʊθ	рот,  устье,  горлышко (бутылки)
deny	dɪ'naɪ	отрицать
fond	fɒnd	нежный,  тёплый
glue	glu:	клей
monk	mʌŋk	монах
alteration	,ɔ:lt(ə)'reɪʃ(ə)n	изменение
climb	klaɪm	взбираться,  карабкаться
picture	'pɪkʧə	картина,  рисунок
marshal	'mɑ:ʃ(ə)l	маршал,  судебный чиновник
illness	'ɪlnəs	болезнь
parasol	'pærəsɒl	балдахин,  тент,  зонтик (от солнца)
regime	reɪ'ʒi:m	режим,  власть,  система
belongings	bɪ'lɒŋɪŋz	принадлежности,  имущество
mushroom	'mʌʃrʊm	гриб
aspect	æspekt	аспект,  (внешний) вид
wage	weɪʤ	заработная плата (рабочих),  вести (войну)
mug	mʌg	кружка,  лицо,  экзамен
love	lʌv	любовь
till	tɪl	до,  денежный ящик,  возделывать землю
emblem	'embləm	символ,  символическое изображение
win	wɪn	победить
wake	weɪk	будить,  след,  отпечаток (от чего-л.)
signify	'sɪgnɪfaɪ	означать
tight	taɪt	тугой,  непроницаемый
patron	'peɪtr(ə)n	покровитель,  патрон,  шеф
afternoon	,ɑ:ftə'nu:n	время после полудня
like	laɪk	похожий,  любить,  нравиться
fry	fraɪ	мелкая рыбёшка,  жарить
swift	swɪft	быстрый,  стриж
gas-stove	'gæsstəʊv	газовая плита
envelop	ɪn'veləp	обёртывать,  завёртывать
loop	lu:p	петля
admiral	ædm(ə)rəl	адмирал,  флагманский корабль
different	'dɪf(ə)r(ə)nt	непохожий,  другой
labour	'leɪbə	труд,  работа
education	,eʤʊ'keɪʃ(ə)n	образование
barren	bær(ə)n	бесплодный,  лишённый (чего-л.)
nation	'neɪʃ(ə)n	народ,  нация
boundless	baʊndləs	безграничный,  бесконечный
fraction	'frækʃ(ə)n	дробь,  доля,  часть
hare	heə	заяц
outstanding	,aʊt'stændɪŋ	выдающийся,   знаменитый,  выступающий (вперёд)
loud	laʊd	громкий
shame	ʃeɪm	стыд
bag	bæg	мешок,  сумка,  вымя
ordinary	'ɔ:d(ə)n(ə)rɪ	обычный,  ординарный
knock	nɒk	стучать,  бить
divide	dɪ'vaɪd	делить (на несколько частей)
splash	splæʃ	забрызгивать,  плескать
punish	'pʌnɪʃ	наказывать
translate	trænz'leɪt	переводить (с одного языка на другой),  перемещать
cap	kæp	кепка,  шапка
empty	'emptɪ	пустой
overwhelming	,əʊvə'welmɪŋ	огромный
straw	strɔ:	солома
obvious	'ɒbvɪəs	очевидный,  заметный
sore	sɔ:	болячка,  рана
spell	spel	заклинание,  писать или произносить по буквам,  срок
ruin	'ru:ɪn	развалины,  руины
cow	kaʊ	корова
team	ti:m	команда,  экипаж
accordion	ə'kɔ:dɪən	аккордеон,  гармоника
despair	dɪ'speə	отчаяние
film	fɪlm	фильм,  киноплёнка
inherit	ɪn'herɪt	наследовать
fountain	'faʊntɪn	источник,  ключ
about	ə'baʊt	кругом,  повсюду,  недалеко
significant	sɪg'nɪfɪkənt	значительный,  важный
mortal	'mɔ:t(ə)l	смертельный,  смертный
lad	læd	юноша,  парень
proclaim	prə'kleɪm	объявлять
rug	rʌg	коврик,  тянуть с силой
own	əʊn	свой,  собственный
edge	eʤ	кромка,  край,  лезвие
tail	teɪl	хвост
ore	ɔ:	руда
forgive	fə'gɪv	прощать
convey	kən'veɪ	перевозить,  передавать (звуки, запахи)
orange	'ɒrɪnʤ	апельсин
absence	æbs(ə)ns	отсутствие
ability	ə'bɪlətɪ	способность,  возможность (делать что-л.)
bubble	bʌbl	пузырёк (воздуха или газа)
regard	rɪ'gɑ:d	внимание,  забота
laugh	lɑ:f	смех
staff	stɑ:f	палка,  посох,  штат служащих
tube	tju:b	труба,  тюбик
bulb	bʌlb	луковица (у лука),  электрическая лампочка
today	tə'deɪ	сегодня
coat	kəʊt	пальто,  покров
cardinal	'kɑ:dɪn(ə)l	главный,  тёмно-красный (о цвете)
require	rɪ'kwaɪə	приказывать,  требовать
august	ɔ:'gʌst	августейший (о монархе),  благородный
chemist	kemɪst	химик,  фармацевт
due	dju:	должный,  обязанный
cease	si:s	переставать (делать что-л.),  прекращать
deaf	def	глухой
technical	'teknɪk(ə)l	технический,  промышленный
deception	dɪ'sepʃ(ə)n	обман,  жульничество
vegetarian	,veʤɪ'teərɪən	вегетарианец
fabric	'fæbrɪk	ткань,  изделие
past	pɑ:st	прошлое,  прошедшее
steam	sti:m	пар
paper	'peɪpə	бумага
drastic	'dræstɪk	сильнодействующий (о лекарстве),  решительный
execute	'eksɪkju:t	выполнять,  делать
credit	'kredɪt	доверие,  вера
zebra	'zebrə   'zi:brə	зебра
drop	drɒp	капать,  лить,  бросать
dim	dɪm	тусклый,  неяркий
forefinger	'fɔ:,fɪŋgə	указательный палец
police	pə'li:s	полиция,  поддерживать порядок (в стране)
cheque	ʧek	банковский чек
now	naʊ	сейчас,  теперь
space	speɪs	пространство
label	'leɪb(ə)l	ярлык,  этикетка
north	nɔ:θ	север
new	nju:	новый
ignore	ɪg'nɔ:	игнорировать,  не придавать значения
alongside	ə,lɒŋ'saɪd	неподалёку,  поблизости,  около
room	ru:m	комната
thread	θred	нитка,  продевать нитку (в иголку)
decree	dɪ'kri:	декрет,  постановление,  решение
fetch	feʧ	принести
money	'mʌnɪ	деньги
bureaucratic	,bjʊərəʊ'krætɪk	бюрократический
dispose	dɪs'pəʊz	располагать,  расставлять
human	'hju:mən	людской,  человеческий
effort	'efət	усилие,  попытка
report	rɪ'pɔ:t	сообщать,  описывать
audience	ɔ:dɪən(t)s	публика,  зрители
yearly	'jɪəlɪ	годовой,  каждый год
canvas	'kænvəs	холст,  парусина
wait	weɪt	ждать
agriculture	ægrɪkʌlʧə	сельское хозяйство
hazard	'hæzəd	риск,  опасность
dimension	daɪ'men(t)ʃ(ə)n	размеры,  величина
arrive	ə'raɪv	прибывать,  приезжать
carrier	'kærɪə	носильщик
constitute	'kɒn(t)stɪtju:t	составлять,  основывать,  принимать (закон)
evident	'evɪd(ə)nt	явный,  очевидный
autobiography	,ɔ:təbaɪ'ɒgrəfɪ	автобиография
mill	mɪl	мельница,  фабрика,  прокатный стан
limit	'lɪmɪt	граница,  ограничивать
fish	fɪʃ	рыба
scatter	'skætə	разбрасывать,  рассыпать
procure	prə'kjʊə	доставать,  добывать
treasure	'treʒə	сокровище
barmaid	bɑ:meɪd	девушка за стойкой,  барменша
severe	sɪ'vɪə	строгий,  суровый
autumn	ɔ:təm	осень (время года)
pupil	'pju:p(ə)l	ученик,  зрачок
resist	rɪ'zɪst	сопротивляться
atlas	ætləs	атлас (сборник карт),  атлант (первый шейный позвонок)
coal	kəʊl	уголь
west	west	запад
shatter	'ʃætə	разбить вдребезги
thrust	θrʌst	колоть,  пронзать,  толкать
chicken	ʧɪkɪn	цыплёнок,  струсить
rare	reə	редкий,  непрожаренный
govern	'gʌv(ə)n	управлять
feather	'feðə	перо (у птиц),  гребень волны
violent	'vaɪəl(ə)nt	интенсивный,  сильный
use	ju:z	использовать,  употреблять
lawyer	'lɒɪə	юрист,  адвокат
cordial	'kɔ:dɪəl	сердечный,  радушный
wealth	welθ	богатство,  состояние
medium	'mi:dɪəm	способ,  средство,  посредник
chop	ʧɒp	рубить,  клеймо,  изменение
undertake	,ʌndə'teɪk	предпринимать,  совершать
community	kə'mju:nətɪ	общность,  государство
fund	fʌnd	запас,  резерв,  источник
horse	hɔ:s	конь,  кавалерия
whom	hu:m	кто?
overhear	,əʊvə'hɪə	подслушивать
general	'ʤen(ə)r(ə)l	общего характера,  повсеместный
dome	dəʊm	величественное здание,  купол
outer	'aʊtə	внешний,  поверхностный
lively	'laɪvlɪ	яркий, живой (о картине, образе)
presence	'prez(ə)n(t)s	присутствие,  наличие
underpass	'ʌndəpɑ:s	тоннель
anger	æŋgə	гнев,  злость  (at, towards, with)
cocktail	'kɒkteɪl	коктейль,  скаковая лошадь-полукровка
perplex	pə'pleks	ставить в тупик, смущать
facility	fə'sɪlətɪ	возможность,  благоприятные условия
say	seɪ	говорить
bear	beə	прош. вр. bore -  носить
study	'stʌdɪ	изучать,  исследовать
reign	reɪn	правление,  власть
eye	aɪ	глаз,  центр
onlooker	'ɒn,lʊkə	зритель,  наблюдатель
bride	braɪd	невеста
association	ə,səʊsɪ'eɪʃ(ə)n	соединение,  объединение,  ассоциация
hospitality	,hɒspɪ'tælətɪ	гостеприимность
palace	'pælɪs	дворец
cripple	'krɪpl	калека (об инвалиде),  получать травму
clean	kli:n	чистый,  опрятный
crate	kreɪt	(деревянный) ящик
weather	'weðə	погода
here	hɪə	здесь,  сейчас
farm	fɑ:m	ферма
assign	ə'saɪn	назначать,  давать,  поручать
invisible	ɪn'vɪzəbl	невидимый
frank	fræŋk	откровенный,  искренний
burden	bɜ:dn	груз,  тяжесть,  основная мысль
most	məʊst	самый большой
harm	hɑ:m	вред,  убыток
trousers	'traʊzəz	брюки
air	eə	воздух,  атмосфера
mourn	mɔ:n	скорбеть,  оплакивать
accidental	,æksɪ'dent(ə)l	случайный
advanced	əd'vɑ:n(t)st	выдвинутый вперёд,  передовой,  современный
duck	dʌk	утка,  неудачник,  нырять,  наклониться
cry	kraɪ	кричать,  плакать
seek	si:k	искать,  добиваться (чего-л.)
ocean	'əʊʃ(ə)n	океан
biscuit	bɪskɪt	сухое печенье,  светло-коричневый цвет
adult	ædʌlt	взрослый,  совершеннолетний
sparrow	'spærəʊ	воробей
buzz	bʌz	жужжать,  суетиться,  сплетничать
role	rəʊl	роль
luggage	'lʌgɪʤ	багаж
night	naɪt	ночь,  вечер
argue	ɑ:gju:	спорить
everything	'evrɪθɪŋ	всё
beach	bi:ʧ	(морской) берег,  отмель
circle	sɜ:kl	круг
disagree	,dɪsə'gri:	не совпадать,  противоречить один другому
disorder	dɪ'sɔ:də	беспорядок
communicate	kə'mju:nɪkeɪt	говорить,  сообщать
observe	əb'zɜ:v	наблюдать,  следить (за чем-л.)
specify	'spesəfaɪ	точно определять,  предписывать
solution	sə'lu:ʃ(ə)n	растворение,  разрешение (вопроса и т. п.)
must	mʌst	должен,  обязан,  заплесневелость,  молодое вино
prescription	prɪs'krɪpʃ(ə)n	директива,  предписание
memory	'mem(ə)rɪ	память
binoculars	bɪ'nɒkjʊləz	бинокль
achieve	ə'ʧi:v	добиваться,  достигать
watch	wɒʧ	часы (карманные, наручные),  смотреть,  наблюдать
defy	dɪ'faɪ	бросать вызов,  сопротивляться
ribbon	'rɪb(ə)n	лента,  ленточка
profit	'prɒfɪt	выгода,  прибыль
ensure	ɪn'ʃʊə	гарантировать
ant	ænt	муравей
parquet	'pɑ:keɪ	паркет,  передние ряды партера
perish	'perɪʃ	погибать
sum	sʌm	сумма,  количество
wine	waɪn	вино
risk	rɪsk	опасность,  риск
light	laɪt	свет,  освещение
quarter	'kwɔ:tə	четверть
helmet	'helmət	каска,  шлем
bead	bi:d	бусина,  капля,  прицел
blame	bleɪm	порицание,  упрёк,  виновность
seize	si:z	схватить,  хватать
leave	li:v	позволение,  разрешение,  покидать
exhaust	ɪg'zɔ:st	исчерпывать,  использовать полностью
senior	'si:nɪə	старший (по возрасту),  вышестоящий
ingredient	ɪn'gri:dɪənt	составная часть,  компонент
cape	keɪp	мыс,  плащ с капюшоном
realize	'rɪəlaɪz	осуществлять,  выполнять
assure	ə'ʃʊə	уверять,  гарантировать
lace	leɪs	шнурок,  кружево
stern	stɜ:n	строгий,  суровый,  корма (мор)
worse	wɜ:s	худший
camp	kæmp	лагерь
sudden	'sʌd(ə)n	внезапный
oak	əʊk	дуб
growth	grəʊθ	развитие,  рост,  урожай
absolute	,æbs(ə)'lu:t	полный, абсолютный, безусловный
blink	blɪŋk	мерцание,  моргание,  щуриться
create	krɪ'eɪt	порождать,  производить,  задумывать (создание чего-л.)
nothing	'nʌθɪŋ	ничего,  ничто
famous	'feɪməs	выдающийся,  знаменитый
physicist	'fɪzɪsɪst	физик
gesture	'ʤesʧə	жест,  телодвижение,  поступок
ankle	æŋkl	лодыжка
architect	ɑ:kɪtekt	архитектор,  зодчий
waist	weɪst	талия
intrude	ɪn'tru:d	вторгаться,  входить без разрешения
burglar	bɜ:glə	вор-домушник,  взломщик
steal	sti:l	воровать
cartridge	'kɑ:trɪʤ	патрон,  кассета
letter	'letə	буква,  письмо
hand	hænd	рука (кисть),  сила,  власть
jam	ʤæm	варенье,  сжимать
sigh	saɪ	вздыхать
unnecessary	ʌn'nesəs(ə)rɪ	ненужный
lighthouse	'laɪthaʊs	маяк
spirit	'spɪrɪt	дух,  привидение
jealous	'ʤeləs	ревнивый
faint	feɪnt	слабый,  вялый
whether	'(h)weðə	ли (вводит косвенный вопрос),  который из двух
discharge	dɪs'ʧɑ:ʤ	разгружать,  выпускать (заряд, стрелу)
descend	dɪ'send	спускаться,  сходить
noble	'nəʊbl	человек благородного происхождения,  дворянин
irresponsible	,ɪrɪ'spɒn(t)səbl	безответственный,  ненадёжный
write	raɪt	писать
entitle	ɪn'taɪtl	давать название
hoarfrost	'hɔ:frɒst	иней,  изморозь
myself	maɪ'self	себя,  меня самого
whoever	hʊ'evə	кто бы ни,  который бы ни
mar	mɑ:	портить,  ухудшать
slippery	'slɪp(ə)rɪ	скользкий,  увёртливый,  ненадёжный
arm	ɑ:m	рука (от кисти до плеча)
bureau	bjʊə'rəʊ	бюро,  комитет,  письменный стол
scrap	skræp	клочок,  обрывок,  драка
administration	əd,mɪnɪs'treɪʃ(ə)n	управление,  ведение (дел),  администрирование
mummy	'mʌmɪ	мумия
postpone	,pəʊst'pəʊn	откладывать,  отсрочивать
arduous	ɑ:djʊəs	трудный,  тяжёлый
deserve	dɪ'zɜ:v	заслуживать,  быть достойным чего-л.
comprise	kəm'praɪz	включать,  заключать в себе,  содержать
bound	baʊnd	граница, ограничивать,  прыжок
dash	dæʃ	бросаться,  мчаться
nude	nju:d	обнажённый,  неукрашенный
nourish	'nʌrɪʃ	кормить,  вскармливать грудью
heat	hi:t	жара,  тепло
alike	ə'laɪk	одинаковый,   похожий
cork	kɔ:k	пробка,  поплавок
door	dɔ:	дверь
grass	grɑ:s	трава
fragile	'fræʤaɪl	ломкий,  хрупкий
fierce	fɪəs	жестокий
barometer	bə'rɒmɪtə	барометр
gross	grəʊs	большой,  буйный (о растительности)
yellow	'jeləʊ	жёлтый
nought	nɔ:t	ничто
pour	pɔ:	литься (о воде),  течение
began	bɪ'gæn	прош.вр. begin - начинать
decay	dɪ'keɪ	гнить,  разрушаться
thirst	θɜ:st	жажда
how	haʊ	как,  каким образом
distribute	dɪ'strɪbju:t	распределять,  раздавать
motto	'mɒtəʊ	девиз,  лозунг
surname	'sɜ:neɪm	фамилия
fellow	'feləʊ	парень,  член какого-л. общества
spare	speə	запасной,  экономить
piece	pi:s	кусок,  чинить,  латать
alone	ə'ləʊn	единственный, один, одинокий
eternal	ɪ'tɜ:n(ə)l	вечный
thousand	'θaʊz(ə)nd	тысяча
hoist	hɒɪst	поднимать (что-л.)
punch	pʌnʧ	удар кулаком,  компостер,  пунш,  ломовая лошадь
rice	raɪs	рис
parrot	'pærət	попугай
enclose	ɪn'kləʊz	окружать,  огораживать
mount	maʊnt	подниматься,  взбираться (на что-л.),  верховая лошадь
post	pəʊst	мачта,  столб,  вывешивать (объявления),  почта
scope	skəʊp	масштаб,  границы (возможностей)
regain	rɪ'geɪn	восстановление,  возвращение (утраченного)
grandchild	'græn(d)ʧaɪld	внук,  внучка
ivory	'aɪv(ə)rɪ	слоновая кость (бивни слонов и мамонтов)
colonel	'kɜ:n(ə)l	полковник
arab	ærəb	араб,  лошадь арабской породы
anything	enɪθɪŋ	что-нибудь
brevity	brevɪtɪ	сжатость,  краткость
pillow	'pɪləʊ	подушка,  подшипник,  класть голову на что-л.
competitor	kəm'petɪtə	конкурент,  противник
measure	'meʒə	мера,  единица измерения
deep	di:p	глубокий
answer	ɑ:n(t)sə	отвечать,  ручаться
hear	hɪə	слышать
though	ðəʊ	хотя,  несмотря на
angel	eɪnʤ(ə)l	ангел,  золотая монета (ист)
native	'neɪtɪv	родной,  врождённый
inspire	ɪn'spaɪə	побуждать,  внушать
greed	gri:d	жадность
navy	'neɪvɪ	военно-морской флот
divorce	dɪ'vɔ:s	развод,  расторжение брака
ahead	ə'hed	будущий,  впереди
beard	bɪəd	борода,  выступать против
internal	ɪn'tɜ:n(ə)l	внутренний
vibrate	vaɪ'breɪt	вибрировать,  колебаться (with - от)
pet	pet	любимое домашнее животное,  дурное настроение
adopt	ə'dɒpt	усыновлять,  удочерять,  принимать
lightning	'laɪtnɪŋ	молния
threaten	'θret(ə)n	грозить,  угрожать (чем-л.)
anthem	ænθəm	гимн,  псалом,  воспевать
addition	ə'dɪʃ(ə)n	добавление,  дополнение
paw	pɔ:	лапа (четвероногих животных имеющих когти)
ounce	aʊn(t)s	унция (единица веса = 28,3 г)
airport	eəpɔ:t	аэропорт
sound	saʊnd	звук,  здоровый,  зонд,  пролив
honest	'ɒnɪst	честный
rescue	'reskju:	спасать
centre	sentə	центр,  середина чего-л.
commonwealth	'kɒmənwelθ	государство,  держава
drain	dreɪn	вытекание,  дренаж,  осушка
beetle	bi:tl	жук,  быстро двигаться,  кувалда,  нависать
oversea	,əʊvə'si:(z)	заморский,  заграничный
base	beɪs	основа,  низкий,   низменный
preserve	prɪ'zɜ:v	сохранять,  консервировать
sea	si:	море
beautiful	bju:təfəl	красивый
size	saɪz	размер,  величина
aisle	aɪl	проход (между рядами)
deceive	dɪ'si:v	обманывать
mineral	'mɪn(ə)r(ə)l	минерал,  полезные ископаемые
blue	blu:	голубой,  синий,  испуганный,  бездумно тратить деньги
aboard	ə'bɔ:d	на борту
unwell	ʌn'wel	нездоровый
veil	veɪl	вуаль,  завеса
craft	krɑ:ft	ремесло,  ловкость
arose	ə'rəʊz	прош. вр arise  возникать, появляться
cash	kæʃ	наличные деньги
doze	dəʊz	дремота,  гниение,  выравнивать грунт
point	pɒɪnt	точка,  пункт
enjoy	ɪn'ʤɒɪ	любить (что-л.),  наслаждаться
drift	drɪft	течение,  перемещение
pass	pɑ:s	проход,  дорога,  идти,  передавать
recognize	'rekəgnaɪz	узнавать,  признавать
attain	ə'teɪn	достигать,  добираться
assume	ə'sju:m	принимать, брать на себя (ответственность, управление)
agrarian	ə'greərɪən	аграрный,  сельскохозяйственный
gratitude	'grætɪtju:d	благодарность,  признательность
margin	'mɑ:ʤɪn	поле (страницы),  край
camel	kæm(ə)l	верблюд
month	mʌnθ	месяц
count	kaʊnt	вычисление,  подсчёт
mate	meɪt	мат (в шахматах),  товарищ
region	'ri:ʤ(ə)n	территория,  область
copper	'kɒpə	медь (металл)
annihilation	ə,naɪə'leɪʃ(ə)n	полное уничтожение,  истребление
bomb	bɒm	бомба,  баллон (для сжатого воздуха)
operate	'ɒp(ə)reɪt	действовать,  приводить в движение
bleed	bli:d	истекать кровью,  bleed for  сочувствовать
stay	steɪ	оставаться,  подпорка
install	ɪn'stɔ:l	вставлять,  устанавливать
chill	ʧɪl	охлаждать,  замораживать,  простуда
fasten	'fɑ:s(ə)n	прикреплять,  застёгивать
principal	'prɪn(t)səp(ə)l	главный,  основной
cage	keɪʤ	клетка,  будка
lobby	'lɒbɪ	вестибюль,  приёмная,  загон для скота
book-keeper	'bʊk,ki:pə	бухгалтер,  счетовод
cave	keɪv	пещера
spark	spɑ:k	искра,  щёголь
pause	pɔ:z	пауза,  перерыв
luxury	'lʌkʃ(ə)rɪ	богатство,  роскошь
noon	nu:n	полдень
convene	kən'vi:n	созывать,  собирать (заседание)
sleep	sli:p	сон,  дремота
glass	glɑ:s	стекло,  стакан,  очки
lime	laɪm	известь,  накипь
laundry	'lɔ:ndrɪ	прачечная,  бельё для стирки
bite	baɪt	кусать,  клевать (о рыбе)
overcome	,əʊvə'kʌm	победить
term	tɜ:m	срок,  период,  называть,  давать имя
hundred	'hʌndrɪd	сто
garment	'gɑ:mənt	предмет одежды
job	ʤɒb	работа,  труд
flute	flu:t	флейта,  бороздка
aviation	,eɪvɪ'eɪʃ(ə)n	авиация
food	fu:d	пища,  еда
way	weɪ	путь,  дорога,  значительно,  очень
learn	lɜ:n	учиться
brief	bri:f	короткий
embassy	'embəsɪ	посольство
leisure	'leʒə	досуг,  свободное время
distinct	dɪ'stɪŋkt	отчётливый,  определённый
empire	'empaɪə	империя
action	ækʃ(ə)n	действие,  поступок,  акция
calm	kɑ:m	спокойный,  тихий
rob	rɒb	грабить
assembly	ə'semblɪ	сбор,  собрание,  ассамблея
archaeology	,ɑ:kɪ'ɒləʤɪ	археология
cargo	'kɑ:gəʊ	груз
daughter	'dɔ:tə	дочь
compose	kəm'pəʊz	сочинять (произведение),  улаживать (ссору)
see	si:	видеть,  смотреть
practise	'præktɪs	применять на практике,  делать по привычке
suitcase	'su:tkeɪs, 'sju:tkeɪs	чемодан (обычно небольшой и плоский)
feature	'fi:ʧə	особенность,  деталь
danger	'deɪnʤə	опасность
violin	,vaɪə'lɪn	скрипка (инструмент)
midnight	'mɪdnaɪt	полночь
inevitable	ɪ'nevɪtəbl	неизбежный
knife	naɪf	нож
gossip	'gɒsɪp	болтовня,  сплетня
wrestling	'reslɪŋ	борьба
aerial	eərɪəl	воздушный,  авиационный
mother	'mʌðə	мать
attempt	ə'tempt	пытаться,  прилагать усилия
anywhere	enɪweə	где-нибудь,  куда-нибудь
armistice	ɑ:mɪstɪs	прекращение военных действий,  перемирие
avert	ə'vɜ:t	отворачиваться,  предотвращать (удар)
atomic	ə'tɒmɪk	атомный,  маленький
uniform	'ju:nɪfɔ:m	форменная одежда,  единообразный
accuracy	ækjərəsɪ	правильность,  соответствие,  точность
belly	belɪ	живот,  внутренности,  раздуваться
assistant	ə'sɪst(ə)nt	помощник,  ассистент
palm	pɑ:m	ладонь,  дотрагиваться,  пальма
lamp	læmp	лампа,  освещать
fence	fen(t)s	забор,  фехтование
necessity	nə'sesətɪ	необходимость,  неизбежность
van	væn	авангард,  фургон
fortnight	'fɔ:tnaɪt	две недели
death	deθ	смерть
stepchild	'stepʧaɪld	пасынок,  падчерица
chief	ʧi:f	руководитель
event	ɪ'vent	событие,  случай
vary	'veərɪ	изменять
hate	heɪt	ненавидеть
arable	ærəbl	пахотный,  пашня
commit	kə'mɪt	совершать (что-л.)
lesson	'les(ə)n	урок,  занятие
furnish	'fɜ:nɪʃ	снабжать,  предоставлять
weapon	'wepən	орудие,  оружие
bystander	baɪ,stændə	свидетель,  наблюдатель
carpenter	'kɑ:p(ə)ntə	плотник
male	meɪl	мужчина,  мужской
towel	'taʊəl	полотенце
send	send	посылать,  отправлять
circulate	'sɜ:kjəleɪt	циркулировать,  двигаться по кругу
cone	kəʊn	конус,  шишка (хвойных деревьев)
broom	bru:m	веник,  метла
board	bɔ:d	доска,  подниматься на борт (корабля),  руководство
gin	ʤɪn	капкан,  подъемная лебёдка
cure	kjʊə	лечение
afford	ə'fɔ:d	быть в состоянии (сделать что-л.),  давать
cloth	klɒθ	ткань,  скатерть
judge	'ʤʌʤ	судья
load	ləʊd	груз,  тяжесть
calendar	'kælɪndə	календарь,  справочник,  регистрировать
ointment	'ɒɪntmənt	мазь
